A.T. Still University of Health Sciences (AZ / MO)	www.atsu.edu
Abilene Christian University (TX)	www.acu.edu
Abraham Baldwin Agricultural College (GA)	www.abac.edu
Academy of Art University (CA)	www.academyart.edu
Adams State College (CO)	www.adams.edu
Adelphi University (NY)	www.adelphi.edu
Adler Graduate School (MN)	www.alfredadler.edu
Adler School of Professional Psychology (IL)	www.adler.edu
Adrian College (MI)	adrian.edu
Adventist University of Health Sciences (FL)	www.adu.edu
Agnes Scott College (GA)	www.agnesscott.edu
AIB College of Business (IA)	www.aib.edu
Air Force Institute of Technology (OH)	www.afit.edu
Air University (AL)	www.au.af.mil
Alabama A&M University (AL)	www.aamu.edu
Alabama State University (AL)	www.alasu.edu
Alaska Bible College (AK)	www.akbible.edu
Alaska Pacific University (AK)	www.alaskapacific.edu
Albany College of Pharmacy & Health Sciences (NY)	www.acphs.edu
Albany Medical College (NY)	www.amc.edu
Albany State University (GA)	www.asurams.edu
Albertus Magnus College (CT)	www.albertus.edu
Albion College (MI)	www.albion.edu
Albright College (PA)	www.albright.edu
Alcorn State University (MS)	www.alcorn.edu
Alderson-Broaddus College (WV)	www.ab.edu
Alfred University (NY)	www.alfred.edu
Alice Lloyd College (KY)	www.alc.edu
Allegheny College (PA)	allegheny.edu
Allen College (IA)	www.allencollege.edu
Allen University (SC)	www.allenuniversity.edu
Alliant International University (CA)	www.alliant.edu
Alma College (MI)	www.alma.edu
Alvernia University (PA)	athletics.alvernia.edu
Alverno College (WI)	www.alverno.edu
Ambassador University (TX) (closed spring 1997)	www.ambassador.edu
Amberton University (TX)	www.amberton.edu
American Academy of Art (IL)	www.aaart.edu
American College of Acupuncture & Oriental Medicine (TX)	www.acaom.edu
American College of Education (IL)	www.ace.edu
The American College of Financial Services (PA)	www.theamericancollege.edu
American Conservatory Theater (CA)	www.act-sf.org
American Film Institute (CA)	www.afi.com
American Indian College of the Assemblies of God (AZ)	www.aicag.edu
American InterContinental University (IL)	www.aiuniv.edu
American International College (MA)	www.aic.edu
American Jewish University (CA)	www.aju.edu
American Military University (WV)	www.amu.apus.edu
American Public University (WV)	www.apus.edu
American University (DC)	www.american.edu
American University of Puerto Rico (PR)	www.aupr.edu
Amherst College (MA)	www.amherst.edu
Amridge University (AL)	amridgeuniversity.edu
Anderson University (SC)	www.andersonuniversity.edu
Anderson University (IN)	www.anderson.edu
Andover Newton Theological School (MA)	www.ants.edu
Andrews University (MI)	www.andrews.edu
Angelo State University (TX)	www.angelo.edu
Anna Maria College (MA)	www.annamaria.edu
Antioch College (OH)	antiochcollege.org
Antioch University–Midwest (OH)	midwest.antioch.edu
Antioch University–New England (NH)	www.antiochne.edu
Antioch University–Los Angeles (CA)	www.antiochla.edu
Antioch University–Santa Barbara (CA)	www.antiochsb.edu
Antioch University–Seattle (WA)	www.antiochseattle.edu
AOMA Graduate School of Integrative Medicine (TX)	aoma.edu
Appalachian Bible College (WV)	www.abc.edu
Appalachian State University (NC)	www.appstate.edu
Aquinas College (MI)	www.aquinas.edu
Aquinas College (TN)	www.aquinascollege.edu
Aquinas Institute of Theology (MO)	ai.edu
Arcadia University (PA)	www.arcadia.edu
Argosy University (IL)	www.argosy.edu
Arizona Christian University (AZ)	arizonachristian.edu
Arizona State University (AZ)	www.asu.edu
Arizona State University–Downtown Phoenix Campus (AZ)	campus.asu.edu
Arizona State–Polytechnic Campus (AZ)	campus.asu.edu
Arizona State University–West Campus (AZ)	campus.asu.edu
Arkansas Baptist College (AR)	www.arkansasbaptist.edu
Arkansas State University (AR)	www.astate.edu
Arkansas Tech University (AR)	www.atu.edu
Arlington Baptist College (TX)	www.arlingtonbaptistcollege.edu
Armstrong Atlantic State University (GA)	www.armstrong.edu
Art Academy of Cincinnati (OH)	www.artacademy.edu
Art Center College of Design (CA)	www.artcenter.edu
Art Institute of Atlanta (GA)	new.artinstitutes.edu
Art Institute of Colorado (CO)	new.artinstitutes.edu
Art Institute of Dallas (TX)	new.artinstitutes.edu
Art Institute of Houston (TX)	new.artinstitutes.edu
Art Institute of Pittsburgh (PA)	new.artinstitutes.edu
Art Institute of Portland (OR)	new.artinstitutes.edu
Art Institute of Seattle (WA)	new.artinstitutes.edu
Asbury Theological Seminary (KY)	asburyseminary.edu
Asbury University (KY)	www.asbury.edu
Ashford University (IA)	www.ashford.edu
Ashland University (OH)	www.ashland.edu
Associated Mennonite Biblical Seminary (IN)	www.ambs.edu
Assumption College (MA)	www.assumption.edu
Athenaeum of Ohio (OH)	www.athenaeum.edu
Athens State University (AL)	www.athens.edu
Auburn University (AL)	www.auburn.edu
Auburn University at Montgomery (AL)	www.aum.edu
Augsburg College (MN)	www.augsburg.edu
Augustana College (IL)	www.augustana.edu
Augustana College (SD)	www.augie.edu
Aurora University (IL)	www.aurora.edu
Austin College (TX)	www.austincollege.edu
Austin Graduate School of Theology (TX)	austingrad.edu
Austin Peay State University (TN)	www.apsu.edu
Austin Presbyterian Theological Seminary (TX)	www.austinseminary.edu
Ave Maria University (FL)	www.avemaria.edu
Averett University (VA)	www.averett.edu
Avila University (MO)	www.avila.edu
Azusa Pacific University (CA)	www.apu.edu
Daemen College (NY)	www.daemen.edu
Dakota State University (SD)	www.dsu.edu
Dakota Wesleyan University (SD)	www.dwu.edu
Dallas Baptist University (TX)	www.dbu.edu
Dallas Christian College (TX)	www.dallas.edu
Dallas Theological Seminary (TX)	www.dts.edu
Dalton State College (GA)	www.daltonstate.edu
Daniel Webster College (NH)	www.dwc.edu
Dartmouth College (NH)	dartmouth.edu
Davenport University (MI)	www.davenport.edu
Davidson College (NC)	www.davidson.edu
Davis College (NY)	www.davisny.edu
Davis & Elkins College (WV)	www.dewv.edu
Daytona State College (FL)	www.daytonastate.edu
Dean College (MA)	www.dean.edu
Defiance College (OH)	www.defiance.edu
Delaware State University (DE)	www.desu.edu
Delaware Valley College (PA)	www.delval.edu
Delta State University (MS)	www.deltastate.edu
Denison University (OH)	denison.edu
Denver Seminary (CO)	www.denverseminary.edu
DePaul University (IL)	www.depaul.edu
DePauw University (IN)	www.depauw.edu
Des Moines University–Osteopathic Medical Center (IA)	www.dmu.edu
DeSales University (PA)	www.desales.edu
DeVry University (IL)	www.devry.edu
DeVry University–Addison (IL)	www.devry.edu
DeVry University–Arlington (VA)	www.devry.edu
DeVry University–Chicago (IL)	www.chi.devry.edu
DeVry University–Georgia (GA)	www.atl.devry.edu
DeVry University–Irving (TX)	www.dal.devry.edu
DeVry University–Kansas City (MO)	www.kc.devry.edu
DeVry University–Long Beach (CA)	www.lb.devry.edu
DeVry University–Orlando (FL)	www.orl.devry.edu
DeVry University–Phoenix (AZ)	www.phx.devry.edu
DeVry University–Pomona (CA)	www.pom.devry.edu
Dickinson College (PA)	www.dickinson.edu
Dickinson State University (ND)	www.dickinsonstate.edu
Dillard University (LA)	www.dillard.edu
Divine Word College (IA)	www.dwci.edu
Dixie State University (UT)	dixie.edu
Doane College (NE)	www.doane.edu
Dominican College (NY)	www.dc.edu
Dominican House of Studies (DC)	www.dhs.edu
Dominican School of Philosophy & Theology (CA)	www.dspt.edu
Dominican University (IL)	www.dom.edu
Dominican University of California (CA)	www.dominican.edu
Donnelly College (KS)	www.donnelly.edu
Dordt College (IA)	www.dordt.edu
Dowling College (NY)	www.dowling.edu
Drake University (IA)	www.drake.edu
Drew University (NJ)	www.drew.edu
Drexel University (PA)	www.drexel.edu
Drury University (MO)	www.drury.edu
Duke University (NC)	duke.edu
Dunwoody College of Technology (MN)	www.dunwoody.edu
Duquesne University (PA)	www.duq.edu
D´Youville College (NY)	www.dyc.edu
Earlham College (IN)	www.earlham.edu
East Carolina University (NC)	www.ecu.edu
East Central University (OK)	www.ecok.edu
East Stroudsburg State University of Pennsylvania (PA)	www.esu.edu
East Tennessee State University (TN)	www.etsu.edu
East Texas Baptist University (TX)	www.etbu.edu
East-West University (IL)	en.wikipedia.org
Eastern Connecticut State University (CT)	www.easternct.edu
Eastern Florida State College (FL)	www.easternflorida.edu
Eastern Illinois University (IL)	www.eiu.edu
Eastern Kentucky University (KY)	www.eku.edu
Eastern Mennonite University (VA)	www.emu.edu
Eastern Michigan University (MI)	www.emich.edu
Eastern Nazarene College (MA)	www1.enc.edu
Eastern New Mexico University (NM)	www.enmu.edu
Eastern Oregon University (OR)	www.eou.edu
Eastern University (PA)	www.eastern.edu
Eastern Virginia Medical School (VA)	www.evms.edu
Eastern Washington University (WA)	www.ewu.edu
Eckerd College (FL)	www.eckerd.edu
ECPI University (VA)	www.ecpi.edu
Eden Theological Seminary (MO)	www.eden.edu
Edgewood College (WI)	www.edgewood.edu
Edinboro University of Pennsylvania (PA)	www.edinboro.edu
EDP College (PR)	www.edpuniversity.edu
Edward Waters College (FL)	www.ewc.edu
Elizabeth City State University (NC)	www.ecsu.edu
Elizabethtown College (PA)	www.etown.edu
Elmhurst College (IL)	public.elmhurst.edu
Elmira College (NY)	www.elmira.edu
Elms College (MA)	www.elms.edu
Elon University (NC)	www.elon.edu
Embry-Riddle Aeronautical University (AZ / FL)	www.erau.edu
Emerson College (MA)	www.emerson.edu
Emmanuel Christian Seminary (TN)	www.ecs.edu
Emmanuel College (GA)	www.ec.edu
Emmanuel College (MA)	www.emmanuel.edu
Emmaus Bible College (IA)	www.emmaus.edu
Emporia State University (KS)	www.emporia.edu
Emory & Henry College (VA)	www.ehc.edu
Emory University (GA)	www.emory.edu
Endicott College (MA)	www.endicott.edu
Erikson Institute (IL)	www.erikson.edu
Erskine College (SC)	www.erskine.edu
Escuela de Artes Plásticas de Puerto Rico (PR)	www.eap.edu
Eureka College (IL)	www.eureka.edu
Evangel University (MO)	www.evangel.edu
Evangelical Theological Seminary (PA)	www.evangelical.edu
Everglades University (FL)	www.evergladesuniversity.edu
Evergreen State College (WA)	www.evergreen.edu
Excelsior College (NY)	www.excelsior.edu
Fairfield University (CT)	www.fairfield.edu
Fairleigh Dickinson University (NJ)	www.fdu.edu
Fairmont State University (WV)	www.fairmontstate.edu
Faith Baptist Bible College & Theological Seminary (IA)	www.faith.edu
Fashion Institute of Design & Merchandising (CA)	fidm.edu
Faulkner University (AL)	www.faulkner.edu
Fayetteville State University (NC)	www.uncfsu.edu
Felician College (NJ)	www.felician.edu
Ferris State University (MI)	www.ferris.edu
Ferrum College (VA)	www.ferrum.edu
Fielding Graduate University (CA)	www.fielding.edu
Finlandia University (MI)	www.finlandia.edu
Fisher College (MA)	www.fisher.edu
Fisk University (TN)	www.fisk.edu
Fitchburg State University (MA)	www.fitchburgstate.edu
Five Towns College (NY)	www.ftc.edu
Flagler College (FL)	www.flagler.edu
Florida Agricultural & Mechanical University (FL)	www.famu.edu
Florida Atlantic University (FL)	www.fau.edu
Florida College (FL)	www.floridacollege.edu
Florida Gulf Coast University (FL)	www.fgcu.edu
Florida Institute of Technology (FL)	www.fit.edu
Florida International University (FL)	www.fiu.edu
Florida Memorial University (FL)	www.fmuniv.edu
Florida National University (FL)	www.fnu.edu
Florida Southern College (FL)	www.flsouthern.edu
Florida SouthWestern State College (FL)	www.fsw.edu
Florida State College at Jacksonville (FL)	www.fscj.edu
Florida State University (FL)	www.fsu.edu
Fontbonne University (MO)	www.fontbonne.edu
Fordham University (NY)	www.fordham.edu
Forest Institute of Professional Psychology (MO)	www.forest.edu
Fort Hays State University (KS)	www.fhsu.edu
Fort Lewis College (CO)	www.fortlewis.edu
Fort Valley State University (GA)	www.fvsu.edu
Framingham State University (MA)	www.framingham.edu
Francis Marion University (SC)	www.fmarion.edu
Franciscan School of Theology (CA)	www.fst.edu
Franciscan University of Steubenville (OH)	www.franciscan.edu
Frank Lloyd Wright School of Architecture (AZ)	www.taliesin.edu
Franklin & Marshall College (PA)	www.fandm.edu
Franklin College (IN)	www.franklincollege.edu
Franklin Pierce University (NH)	www.franklinpierce.edu
Franklin University (OH)	www.franklin.edu
Franklin W. Olin College of Engineering (MA)	www.olin.edu
Freed-Hardeman University (TN)	www.fhu.edu
Fresno Pacific University (CA)	www.fresno.edu
Friends University (KS)	www.friends.edu
Frontier Nursing University (KY)	www.frontier.edu
Frostburg State University (MD)	www.frostburg.edu
Fuller Theological Seminary (CA)	www.fuller.edu
Furman University (SC)	www2.furman.edu
Future Generations Graduate School (WV)	www.future.org
Gallaudet University (DC)	www.gallaudet.edu
Gannon University (PA)	www.gannon.edu
Gardner-Webb University (NC)	www.gardner-webb.edu
Garrett-Evangelical Theological Seminary (IL)	www.garrett.edu
Geneva College (PA)	www.geneva.edu
George Fox University (OR)	www.georgefox.edu
George Mason University (VA)	www.gmu.edu
George Washington University (DC)	www.gwu.edu
George Washington University–Virginia Science & Technology Campus (VA)	virginia.gwu.edu
Georgetown College (KY)	www.georgetowncollege.edu
Georgetown University (DC)	www.georgetown.edu
Georgia College & State University (GA)	www.gcsu.edu
Georgia Gwinnett College (GA)	www.ggc.edu
Georgia Institute of Technology (GA)	www.gatech.edu
Georgia Regents University (GA)	www.gru.edu
Georgia Southern University (GA)	www.georgiasouthern.edu
Georgia Southwestern State University (GA)	gsw.edu
Georgia State University (GA)	www.gsu.edu
Georgian Court University (NJ)	www.georgian.edu
Gettysburg College (PA)	www.gettysburg.edu
Glenville State College (WV)	www.glenville.edu
Global University (MO)	www.globaluniversity.edu
God's Bible School & College (OH)	www.gbs.edu
Goddard College (VT)	www.goddard.edu
Golden Gate Baptist Theological Seminary (CA)	www.ggbts.edu
Golden Gate University (CA)	www.ggu.edu
Goldey-Beacom College (DE)	www.gbc.edu
Goldfarb School of Nursing at Barnes-Jewish College (MO)	www.barnesjewishcollege.edu
Gonzaga University (WA)	www.gonzaga.edu
Goodwin College (CT)	www.goodwin.edu
Gordon State College (GA)	www.gordonstate.edu
Gordon College (MA)	www.gordon.edu
Gordon-Conwell Theological Seminary (MA)	www.gordonconwell.edu
Goshen College (IN)	www.goshen.edu
Goucher College (MD)	www.goucher.edu
Governors State University (IL)	www.govst.edu
Grace Bible College (MI)	www.gbcol.edu
Grace College & Seminary (IN)	www.grace.edu
Grace University (NE)	www.graceuniversity.edu
Graceland University (IA)	www.graceland.edu
Graduate Institute of Applied Linguistics (TX)	www.gial.edu
Graduate Theological Union (CA)	gtu.edu
Grambling State University (LA)	www.gram.edu
Grand Canyon University (AZ)	www.gcu.edu
Grand Valley State University (MI)	www.gvsu.edu
Grand View University (IA)	www.grandview.edu
Granite State College (NH)	www.granite.edu
Gratz College (PA)	www.gratz.edu
Great Basin College (NV)	www.gbcnv.edu
Great Lakes Christian College (MI)	www.glcc.edu
Green Mountain College (VT)	greenmtn.edu
Greensboro College (NC)	www.greensboro.edu
Greenville College (IL)	www.greenville.edu
Grinnell College (IA)	www.grinnell.edu
Grove City College (PA)	www.gcc.edu
Guilford College (NC)	www.guilford.edu
Gulf Coast State College (FL)	www.gulfcoast.edu
Gustavus Adolphus College (MN)	gustavus.edu
Gwynedd Mercy University (PA)	www.gmercyu.edu
Icahn School of Medicine at Mount Sinai (NY)	icahn.mssm.edu
Idaho State University (ID)	www.isu.edu
Iliff School of Theology (CO)	www.iliff.edu
Illinois College (IL)	www.ic.edu
Illinois College of Optometry (IL)	www.ico.edu
Illinois Institute of Art (IL)	new.artinstitutes.edu
Illinois Institute of Art–Schaumburg (IL)	new.artinstitutes.edu
Illinois Institute of Technology (IL)	web.iit.edu
Illinois State University (IL)	illinoisstate.edu
Illinois Wesleyan University (IL)	www.iwu.edu
Immaculata University (PA)	www.immaculata.edu
Indian River State College (FL)	www.irsc.edu
Indiana Institute of Technology (IN)	www.indianatech.edu
Indiana State University (IN)	cms.indstate.edu
Indiana University–Bloomington (IN)	www.iub.edu
Indiana University–East (IN)	www.iue.edu
Indiana University–Kokomo (IN)	www.iuk.edu
Indiana University–Northwest (IN)	www.iun.edu
Indiana University–South Bend (IN)	www.iusb.edu
Indiana University–Southeast (IN)	www.ius.edu
Indiana University System (IN)	www.indiana.edu
Indiana University/Purdue University at Columbus (IN)	www.iupuc.edu
Indiana University/Purdue University at Fort Wayne (IN)	www.ipfw.edu
Indiana University/Purdue University at Indianapolis (IN)	www.iupui.edu
Indiana University of Pennsylvania (PA)	www.iup.edu
Indiana Wesleyan University (IN)	www.indwes.edu
Institute for Clinical Social Work (IL)	www.icsw.edu
Institute for the Psychological Sciences (VA)	ipsciences.edu
Institute of American Indian Arts (NM)	www.iaia.edu
Institute of World Politics (DC)	www.iwp.edu
Interdenominational Theological Center (GA)	www.itc.edu
Iona College (NY)	www.iona.edu
Iowa State University (IA)	www.iastate.edu
Iowa Wesleyan College (IA)	www.iwc.edu
Irell & Manella Graduate School of Biological Sciences (CA)	www.cityofhope.org
Ithaca College (NY)	www.ithaca.edu
Jackson State University (MS)	www.jsums.edu
Jacksonville University (FL)	www.ju.edu
Jacksonville State University (AL)	www.jsu.edu
James Madison University (VA)	www.jmu.edu
Jarvis Christian College (TX)	www.jarvis.edu
Jefferson College of Health Sciences (VA)	www.jchs.edu
The Jewish Theological Seminary of America (NY)	www.jtsa.edu
John Brown University (AR)	www.jbu.edu
John Carroll University (OH)	sites.jcu.edu
John F. Kennedy University (CA)	www.jfku.edu
John Marshall Law School (IL)	www.jmls.edu
Johns Hopkins University (MD)	www.jhu.edu
Johnson University (TN)	www.johnsonu.edu
Johnson University Florida (FL)	www.johnsonu.edu
Johnson C. Smith University (NC)	www.jcsu.edu
Johnson State College (VT)	www.jsc.edu
Johnson & Wales University (RI)	www.jwu.edu
Jones International University (CO)	www.jiu.edu
Judson College (AL)	www.judson.edu
Judson University (IL)	www.judsonu.edu
The Juilliard School (NY)	www.juilliard.edu
Juniata College (PA)	www.juniata.edu
La Roche College (PA)	www.laroche.edu
La Salle University (PA)	www.lasalle.edu
La Sierra University (CA)	lasierra.edu
Labouré College (MA)	www.laboure.edu
Lafayette College (PA)	www.lafayette.edu
LaGrange College (GA)	www.lagrange.edu
Laguna College of Art & Design (CA)	www.lcad.edu
Lake Erie College (OH)	www.lec.edu
Lake Erie College of Osteopathic Medicine (PA)	www.lecom.edu
Lake Forest College (IL)	www.lakeforest.edu
Lake Forest Graduate School of Management (IL)	www.lakeforestmba.edu
Lake Superior State University (MI)	www.lssu.edu
Lake-Sumter State College (FL)	www.lssc.edu
Lakeland College (WI)	lakeland.edu
Lakeview College of Nursing (IL)	www.lakeviewcol.edu
Lamar University (TX)	www.lamar.edu
Lancaster Bible College (PA)	www.lbc.edu
Lancaster Theological Seminary (PA)	lancasterseminary.edu
Lander University (SC)	www.lander.edu
Landmark College (VT)	www.landmark.edu
Lane College (TN)	www.lanecollege.edu
Langston University (OK)	www.langston.edu
Lasell College (MA)	www.lasell.edu
Lawrence Technological University (MI)	www.ltu.edu
Lawrence University (WI)	www.lawrence.edu
Le Moyne College (NY)	www.lemoyne.edu
Lebanon Valley College (PA)	www.lvc.edu
Lee University (TN)	www.leeuniversity.edu
Lees-McRae College (NC)	www.lmc.edu
Lehigh University (PA)	www.lehigh.edu
LeMoyne-Owen College (TN)	www.loc.edu
Lenoir-Rhyne University (NC)	www.lr.edu
Lesley University (MA)	www.lesley.edu
LeTourneau University (TX)	www.letu.edu
Lewis & Clark College (OR)	www.lclark.edu
Lewis-Clark State College (ID)	www.lcsc.edu
Lewis University (IL)	www.lewisu.edu
Lexington College (IL)	www.lexingtoncollege.edu
Liberty University (VA)	www.liberty.edu
Life Pacific College (CA)	lifepacific.edu
Life University (GA)	www.life.edu
LIM College (NY)	www.limcollege.edu
Limestone College (SC)	www.limestone.edu
Lincoln Christian University (IL)	www.lincolnchristian.edu
Lincoln College (IL)	lincolncollege.edu
Lincoln College of New England (CT)	www.lincolncollegene.edu
Lincoln Memorial University (TN)	www.lmunet.edu
Lincoln University (MO)	www.lincolnu.edu
Lincoln University (PA)	www.lincoln.edu
Lindenwood University (MO)	www.lindenwood.edu
Lindsey Wilson College (KY)	www.lindsey.edu
Linfield College (OR)	www.linfield.edu
Lipscomb University (TN)	www.lipscomb.edu
Livingstone College (NC)	www.livingstone.edu
Lock Haven University of Pennsylvania (PA)	www.lhup.edu
Logan University (MO)	www.logan.edu
Loma Linda University (CA)	www.llu.edu
Long Island University (NY)	www.liu.edu
Long Island University–Arnold & Marie Schwartz College of Pharmacy & Health Sciences	www.liu.edu
Long Island University–Brentwood Campus	www.liu.edu
Long Island University–Brooklyn Campus	www.liu.edu
Long Island University–C.W. Post Campus	www.liu.edu
Long Island University–Hudson	www.liu.edu
Long Island University–Riverhead	www.liu.edu
Longwood University (VA)	www.longwood.edu
Longy School of Music (MA)	www.longy.edu
Loras College (IA)	www.loras.edu
Louisiana College (LA)	www.lacollege.edu
Louisiana State University (LA)	www.lsu.edu
Louisiana State University–Alexandria (LA)	www.lsua.edu
Louisiana State University–Law Center	www.law.lsu.edu
Louisiana State University Health Sciences Center–New Orleans (LA)	www.lsuhsc.edu
Louisiana State University Health Sciences Center–Shreveport	www.lsuhscshreveport.edu
Louisiana State University–Shreveport (LA)	www.lsus.edu
Louisiana State University System (LA)	www.lsusystem.edu
Louisiana Tech University (LA)	www.latech.edu
Louisville Presbyterian Theological Seminary (KY)	www.lpts.edu
Lourdes University (OH)	www.lourdes.edu
Loyola University Maryland (MD)	www.loyola.edu
Loyola Marymount University (CA)	www.lmu.edu
Loyola University Chicago (IL)	www.luc.edu
Loyola University New Orleans (LA)	www.loyno.edu
Lubbock Christian University (TX)	www.lcu.edu
Luther College (IA)	www.luther.edu
Luther Seminary (MN)	www.luthersem.edu
Lutheran School of Theology at Chicago (IL)	www.lstc.edu
Lutheran Theological Seminary at Gettysburg (PA)	www.ltsg.edu
Lutheran Theological Seminary at Philadelphia (PA)	ltsp.edu
Lycoming College (PA)	www.lycoming.edu
Lyme Academy College of Fine Arts (CT)	www.lymeacademy.edu
Lynchburg College (VA)	www.lynchburg.edu
Lyndon State College (VT)	lyndonstate.edu
Lynn University (FL)	www.lynn.edu
Lyon College (AR)	www.lyon.edu
Naropa University (CO)	www.naropa.edu
National American University (SD)	www.national.edu
National College of Natural Medicine (OR)	www.ncnm.edu
National Defense University (DC)	www.ndu.edu
National Graduate School of Quality Management (MA)	ngs.edu
National Hispanic University (CA)	www.nhu.edu
National Intelligence University (DC)	www.ni-u.edu
National Labor College (MD)	www.nlc.edu
National-Louis University (IL)	www.nl.edu
National University (CA)	www.nu.edu
National University of Health Sciences (IL)	www.nuhs.edu
Navajo Technical University (NM)	www.navajotech.edu
Naval Postgraduate School (CA)	www.nps.edu
Nazarene Bible College (CO)	www.nbc.edu
Nazareth College (NY)	www2.naz.edu
Nebraska Christian College (NE)	www.nechristian.edu
Nebraska Methodist College (NE)	www.methodistcollege.edu
Nebraska Wesleyan University (NE)	www.nebrwesleyan.edu
Neumann University (PA)	www.neumann.edu
New College of Florida (FL)	www.ncf.edu
New England College (NH)	www.nec.edu
New England College of Business & Finance (MA)	www.necb.edu
New England College of Optometry (MA)	www.neco.edu
New England Conservatory of Music (MA)	necmusic.edu
New England Institute of Art (MA)	new.artinstitutes.edu
New England Institute of Technology (RI)	www.neit.edu
New Hope Christian College (OR)	www.newhope.edu
New Jersey City University (NJ)	www.njcu.edu
New Jersey Institute of Technology (NJ)	www.njit.edu
New Mexico Highlands University (NM)	www.nmhu.edu
New Mexico Institute of Mining & Technology (NM)	www.nmt.edu
New Mexico State University (NM)	www.nmsu.edu
New Orleans Baptist Theological Seminary (LA)	www.nobts.edu
The New School (NY)	www.newschool.edu
New York Chiropractic College (NY)	www.nycc.edu
New York Institute of Technology (NY)	www.nyit.edu
New York Medical College (NY)	www.nymc.edu
New York University (NY)	www.nyu.edu
Newberry College (SC)	www.newberry.edu
Newbury College (MA)	www.newbury.edu
Newman University (KS)	www.newmanu.edu
NewSchool of Architecture & Design (CA)	newschoolarch.edu
Niagara University (NY)	www.niagara.edu
Nichols College (MA)	www.nichols.edu
Nicholls State University (LA)	www.nicholls.edu
Norfolk State University (VA)	www.nsu.edu
North Carolina A&T State University (NC)	www.ncat.edu
North Carolina Central University (NC)	www.nccu.edu
North Carolina Wesleyan College (NC)	www.ncwc.edu
North Central University (MN)	www.northcentral.edu
North Central College (IL)	northcentralcollege.edu
North Carolina State University (NC)	www.ncsu.edu
North Dakota State University (ND)	www.ndsu.edu
North Greenville University (SC)	www.ngu.edu
North Park University (IL)	www.northpark.edu
Northcentral University (AZ)	www.ncu.edu
Northeast Ohio Medical University (OH)	www.neomed.edu
Northeastern Illinois University (IL)	www.neiu.edu
Northeastern Seminary at Roberts Wesleyan College (NY)	www.nes.edu
Northeastern State University (OK)	www.nsuok.edu
Northeastern State University–Broken Arrow (OK)	www.nsuok.edu
Northeastern State University–Muskogee (OK)	www.nsuok.edu
Northeastern University (MA)	www.northeastern.edu
Northern Arizona University (AZ)	www.nau.edu
Northern Baptist Theological Seminary (IL)	www.seminary.edu
Northern Illinois University (IL)	www.niu.edu
Northern Kentucky University (KY)	www.nku.edu
Northern Michigan University (MI)	www.nmu.edu
Northern New Mexico College (NM)	nnmc.edu
Northern State University (SD)	www.northern.edu
Northland College (WI)	www.northland.edu
Northwest Christian University (OR)	www.nwcu.edu
Northwest Florida State College (FL)	www.nwfsc.edu
Northwest Indian College (WA)	www.nwic.edu
Northwest Missouri State University (MO)	www.nwmissouri.edu
Northwest Nazarene University (ID)	www.nnu.edu
Northwest University (WA)	www.northwestu.edu
Northwestern College (IA)	www.nwciowa.edu
Northwestern Health Sciences University (MN)	www.nwhealth.edu
Northwestern Oklahoma State University (OK)	www.nwosu.edu
Northwestern State University (LA)	www.nsula.edu
Northwestern University (IL)	www.northwestern.edu
Northwood University (FL / MI / TX)	www.northwood.edu
Norwich University (VT)	www.norwich.edu
Notre Dame College (OH)	www.notredamecollege.edu
Notre Dame de Namur University (CA)	www.ndnu.edu
Notre Dame Seminary (LA)	nds.edu
Nova Southeastern University (FL)	www.nova.edu
Nyack College (NY)	www.nyack.edu
Oak Hills Christian College (MN)	www.oakhills.edu
Oakland City University (IN)	www.oak.edu
Oakland University (MI)	www.oakland.edu
Oakwood University (AL)	www.oakwood.edu
Oberlin College (OH)	www.oberlin.edu
Oblate School of Theology (TX)	www.ost.edu
Occidental College (CA)	www.oxy.edu
Oglala Lakota College (SD)	www.olc.edu
Oglethorpe University (GA)	www.oglethorpe.edu
Ohio Christian University (OH)	www.ohiochristian.edu
Ohio Dominican University (OH)	www.ohiodominican.edu
Ohio Northern University (OH)	www.onu.edu
Ohio State University (OH)	www.osu.edu
Ohio State University–Lima (OH)	lima.osu.edu
Ohio State University–Mansfield (OH)	mansfield.osu.edu
Ohio State University–Marion (OH)	osumarion.osu.edu
Ohio State University–Newark (OH)	newark.osu.edu
Ohio University (OH)	www.ohio.edu
Ohio University–Eastern Campus	www.ohio.edu
Ohio University–Lancaster	www.ohio.edu
Ohio University–Zanesville (OH)	www.ohio.edu
Ohio Valley University (WV)	www.ovu.edu
Ohio Wesleyan University (OH)	www.owu.edu
Oklahoma Baptist University (OK)	www.okbu.edu
Oklahoma Christian University (OK)	www.oc.edu
Oklahoma City University (OK)	www.okcu.edu
Oklahoma Panhandle State University (OK)	www.opsu.edu
Oklahoma State University (OK)	www.okstate.edu
Oklahoma State University–Center for Health Sciences (OK)	www.healthsciences.okstate.edu
Oklahoma State University–Institute of Technology (OK)	go.osuit.edu
Oklahoma State University–Oklahoma City (OK)	www.osuokc.edu
Oklahoma State University–Tulsa (OK)	www.osu-tulsa.okstate.edu
Oklahoma Wesleyan University (OK)	www.okwu.edu
Old Dominion University (VA)	www.odu.edu
Olivet College (MI)	www.olivetcollege.edu
Olivet Nazarene University (IL)	www.olivet.edu
Olivet University (CA)	www.olivetuniversity.edu
Olympic College (WA)	www.olympic.edu
Oral Roberts University (OK)	www.oru.edu
Oregon College of Art & Craft (OR)	www.ocac.edu
Oregon Health & Science University (OR)	www.ohsu.edu
Oregon Institute of Technology (OR)	www.oit.edu
Oregon State University (OR)	oregonstate.edu
Otis College of Art & Design (CA)	www.otis.edu
Ottawa University (KS)	www.ottawa.edu
Otterbein University (OH)	www.otterbein.edu
Ouachita Baptist University (AR)	www.obu.edu
Our Lady of Holy Cross College (LA)	www.olhcc.edu
Our Lady of the Lake College (LA)	www.ololcollege.edu
Our Lady of the Lake University (TX)	www.ollusa.edu
Ozark Christian College (MO)	occ.edu
Queens University of Charlotte (NC)	www.queens.edu
Quincy University (IL)	www.quincy.edu
Quinnipiac University (CT)	www.quinnipiac.edu
Radford University (VA)	www.radford.edu
Ramapo College of New Jersey (NJ)	www.ramapo.edu
Randolph College (VA)	www.randolphcollege.edu
Randolph-Macon College (VA)	www.rmc.edu
Ranken Technical College (MO)	www.ranken.edu
Rasmussen College (FL / IL / MN / ND / WI)	www.rasmussen.edu
Reconstructionist Rabbinical College (PA)	www.rrc.edu
Reed College (OR)	www.reed.edu
Reformed Theological Seminary (MS)	www.rts.edu
Regent University (VA)	www.regent.edu
Regis College (MA)	www.regiscollege.edu
Regis University (CO)	www.regis.edu
Reinhardt University (GA)	www.reinhardt.edu
Rensselaer Polytechnic Institute (NY)	www.rpi.edu
Research College of Nursing (MO)	researchcollege.edu
Resurrection University (IL)	resu.edu
Rhode Island College (RI)	www.ric.edu
Rhode Island School of Design (RI)	www.risd.edu
Rhodes College (TN)	www.rhodes.edu
Rice University (TX)	www.rice.edu
Richard Stockton College of New Jersey (NJ)	www.stockton.edu
Richmont Graduate University (TN)	richmont.edu
Rider University (NJ)	www.rider.edu
Ringling College of Art & Design (FL)	www.ringling.edu
Ripon College (WI)	www.ripon.edu
Rivier University (NH)	www.rivier.edu
Roanoke College (VA)	roanoke.edu
Robert Morris University (PA)	www.rmu.edu
Robert Morris University–Illinois (IL)	www.robertmorris.edu
Roberts Wesleyan College (NY)	www.roberts.edu
Rochester College (MI)	www.rc.edu
Rochester Institute of Technology (NY)	www.rit.edu
Rockford University (IL)	www.rockford.edu
Rockhurst University (MO)	www.rockhurst.edu
Rocky Mountain College (MT)	www.rocky.edu
Rocky Mountain College of Art & Design (CO)	www.rmcad.edu
Roger Williams University (RI)	www.rwu.edu
Rogers State University (OK)	www.rsu.edu
Rollins College (FL)	www.rollins.edu
Roosevelt University (IL)	www.roosevelt.edu
Rosalind Franklin University of Medicine & Science (IL)	www.rosalindfranklin.edu
Rose-Hulman Institute of Technology (IN)	www.rose-hulman.edu
Roseman University of Health Sciences (AZ)	www.roseman.edu
Rosemont College (PA)	www.rosemont.edu
Rowan University (NJ)	www.rowan.edu
Rush University (IL)	www.rushu.rush.edu
Rust College (MS)	www.rustcollege.edu
Rutgers University–Camden (NJ)	www.camden.rutgers.edu
Rutgers University–New Brunswick (NJ)	nb.rutgers.edu
Rutgers University–Newark (NJ)	www.newark.rutgers.edu
Tabor College (KS)	www.tabor.edu
Talladega College (AL)	www.talladega.edu
Tarleton State University (TX)	www.tarleton.edu
Taylor University (IN)	www.taylor.edu
TCM International Institute (IN)	www.tcmi.org
Temple University (PA)	www.temple.edu
Tennessee State University (TN)	www.tnstate.edu
Tennessee Technological University (TN)	www.tntech.edu
Tennessee Wesleyan College (TN)	www.twcnet.edu
Texas A&M International University (TX)	www.tamiu.edu
Texas A&M University (TX)	www.tamu.edu
Texas A&M University–Central Texas (TX)	www.tamuct.org
Texas A&M University–Commerce (TX)	www.tamuc.edu
Texas A&M University–Corpus Christi (TX)	www.tamucc.edu
Texas A&M University–Galveston (TX)	www.tamug.edu
Texas A&M University Health Science Center (TX)	medicine.tamhsc.edu
Texas A&M University–Kingsville (TX)	www.tamuk.edu
Texas A&M University–San Antonio (TX) (operates as branch of Texas A&M University–Kingsville)	en.wikipedia.org
Texas A&M University–Texarkana (TX)	tamut.edu
Texas Chiropractic College (TX)	www.txchiro.edu
Texas Christian University (TX)	www.tcu.edu
Texas College (TX)	www.texascollege.edu
Texas Lutheran University (TX)	www.tlu.edu
Texas Southern University (TX)	www.tsu.edu
Texas State University–San Marcos (TX)	www.txstate.edu
Texas Tech University (TX)	www.ttu.edu
Texas Tech University Health Sciences Center (TX)	www.ttuhsc.edu
Texas Wesleyan University (TX)	txwes.edu
Texas Woman's University (TX)	www.twu.edu
Thiel College (PA)	www.thiel.edu
Thomas Aquinas College (CA)	www.thomasaquinas.edu
Thomas University (GA)	www.thomasu.edu
Thomas College (ME)	www.thomas.edu
Thomas Edison State College (NJ)	www.tesc.edu
Thomas Jefferson University (PA)	www.jefferson.edu
Thomas M. Cooley Law School (MI)	www.cooley.edu
Thomas More College (KY)	www.thomasmore.edu
The Thomas More College of Liberal Arts (NH)	www.thomasmorecollege.edu
Thunderbird School of Global Management (AZ)	www.thunderbird.edu
Tiffin University (OH)	www.tiffin.edu
Toccoa Falls College (GA)	www.tfc.edu
Tougaloo College (MS)	www.tougaloo.edu
Touro College (NY)	www.touro.edu
Touro College Los Angeles (CA)	legacy.touro.edu
Touro University California (CA)	www.tu.edu
Touro University Nevada (NV)	tun.touro.edu
Touro University Worldwide (CA)	www.tuw.edu
Towson University (MD)	www.towson.edu
Toyota Technological Institute at Chicago (IL)	www.ttic.edu
Transylvania University (KY)	www.transy.edu
Trevecca Nazarene University (TN)	www.trevecca.edu
Trident University International (CA)	www.trident.edu
Trine University (IN)	www.trine.edu
Trinity Bible College (ND)	www.trinitybiblecollege.edu
Trinity Christian College (IL)	www.trnty.edu
Trinity College (CT)	www.trincoll.edu
Trinity College of Nursing & Health Sciences (IL)	www.trinitycollegeqc.edu
Trinity Lutheran Seminary (OH)	www.tlsohio.edu
Trinity University (DC)	www.trinitydc.edu
Trinity College of Florida (FL)	www.trinitycollege.edu
Trinity International University (IL)	www.tiu.edu
Trinity Lutheran College (WA)	www.tlc.edu
Trinity University (TX)	new.trinity.edu
Troy University (AL)	www.troy.edu
Truett-McConnell College (GA)	www.truett.edu
Truman State University (MO)	www.truman.edu
Tufts University (MA)	www.tufts.edu
Tulane University (LA)	tulane.edu
Turtle Mountain Community College (ND)	www.tm.edu
Tusculum College (TN)	www.tusculum.edu
Tuskegee University (AL)	www.tuskegee.edu
Unification Theological Seminary (NY)	www.uts.edu
Uniformed Services University of the Health Sciences (MD)	www.usuhs.mil
Union College (KY)	www.unionky.edu
Union College (NE)	www.ucollege.edu
Union College (NY)	www.union.edu
Union Graduate College (NY)	www.uniongraduatecollege.edu
Union Institute & University (OH)	www.myunion.edu
Union Presbyterian Seminary (VA)	www.upsem.edu
Union Theological Seminary (NY)	www.utsnyc.edu
Union University (TN)	www.uu.edu
United States Air Force Academy (CO)	www.usafa.af.mil
United States Army Command & General Staff College (KS)	en.wikipedia.org
United States Army War College (PA)	www.carlisle.army.mil
United States Coast Guard Academy (CT)	en.wikipedia.org
United States Merchant Marine Academy (NY)	www.usmma.edu
United States Military Academy (NY)	www.usma.edu
United States Naval Academy (MD)	www.usna.edu
United States Naval War College (RI)	www.usnwc.edu
United States Sports Academy (AL)	ussa.edu
United States University (CA)	www.usuniversity.edu
United Theological Seminary (OH)	united.edu
United Theological Seminary of the Twin Cities (MN)	www.unitedseminary.edu
Unity College (ME)	www.unity.edu
Universidad Adventista de las Antillas (PR)	www.uaa.edu
Universidad Central de Bayamón (PR)	www.ucb.edu.pr
Universidad Central del Caribe (PR)	www.uccaribe.edu
Universidad del Sagrado Corazón (PR)	www.sagrado.edu
Universidad Interamericana de Puerto Rico (PR)	www.inter.edu
Universidad Interamericana de Puerto Rico (PR) Aguadilla Campus	aguadilla.inter.edu
Universidad Interamericana de Puerto Rico (PR) Arecibo Campus	www.arecibo.inter.edu
Universidad Interamericana de Puerto Rico (PR) Barranquitas Campus	www.br.inter.edu
Universidad Interamericana de Puerto Rico (PR) Bayamón Campus	bayamon.inter.edu
Universidad Interamericana de Puerto Rico (PR) Fajardo Campus	fajardo.inter.edu
Universidad Interamericana de Puerto Rico (PR) Guayama Campus	www.guayama.inter.edu
Universidad Interamericana de Puerto Rico (PR) Metropolitan Campus	www.metro.inter.edu
Universidad Interamericana de Puerto Rico (PR) Ponce Campus	ponce.inter.edu
Universidad Interamericana de Puerto Rico (PR) San Germán Campus	www.sg.inter.edu
Universidad Interamericana de Puerto Rico (PR) School of Law	www.derecho.inter.edu
Universidad Interamericana de Puerto Rico (PR) School of Optometry	www.optonet.inter.edu
Universidad Politecnica de Puerto Rico (PR)	www.pupr.edu
University System of Maryland (MD)	www.usmd.edu
Upper Iowa University (IA)	www.uiu.edu
Urbana University (OH)	www.urbana.edu
Ursinus College (PA)	www.ursinus.edu
Ursuline College (OH)	www.ursuline.edu
Utah State University (UT)	www.usu.edu
Utah Valley University (UT)	www.uvu.edu
Utica College (NY)	www.utica.edu
University of Advancing Technology (AZ)	www.uat.edu
University of Akron (OH)	www.uakron.edu
University of Alabama (AL)	www.ua.edu
University of Alabama–Birmingham (AL)	www.uab.edu
University of Alabama–Huntsville (AL)	www.uah.edu
University of Alaska System (AK)	www.alaska.edu
University of Alaska System (AK) Anchorage	www.uaf.edu
University of Alaska System (AK) Fairbanks	www.alaska.edu
University of Alaska System (AK) Southeast (Juneau)	www.uas.alaska.edu
University of Arizona (AZ)	www.arizona.edu
University of Arkansas (AR)	www.uark.edu
University of Arkansas–Fort Smith (AR)	uafs.edu
University of Arkansas–Little Rock (AR)	ualr.edu
University of Arkansas for Medical Sciences (AR)	www.uams.edu
University of Arkansas–Monticello (AR)	www.uamont.edu
University of Arkansas–Pine Bluff (AR)	www.uapb.edu
University of Arkansas System (AR)	www.uasys.edu
University of Baltimore (MD)	www.ubalt.edu
University of Bridgeport (CT)	www.bridgeport.edu
University of California–Berkeley (CA)	www.berkeley.edu
University of California–Davis (CA)	www.ucdavis.edu
University of California Hastings College of the Law (CA)	www.uchastings.edu
University of California–Irvine (CA)	uci.edu
University of California–Los Angeles (CA)	www.ucla.edu
University of California–Merced (CA)	www.ucmerced.edu
University of California–Riverside (CA)	www.ucr.edu
University of California–San Diego (CA)	ucsd.edu
University of California–San Francisco (CA)	www.ucsf.edu
University of California–Santa Barbara (CA)	www.ucsb.edu
University of California–Santa Cruz (CA)	www.ucsc.edu
University of California System (CA)	www.universityofcalifornia.edu
University of Central Arkansas (AR)	uca.edu
University of Central Florida (FL)	www.ucf.edu
University of Central Missouri (MO)	www.ucmo.edu
University of Central Oklahoma (OK)	www.uco.edu
University of Charleston (WV)	www.ucwv.edu
University of Chicago (IL)	www.uchicago.edu
University of Cincinnati (OH)	www.uc.edu
University of Cincinnati–Blue Ash (OH)	www.ucblueash.edu
University of Colorado–Boulder (CO)	www.colorado.edu
University of Colorado–Colorado Springs (CO)	www.uccs.edu
University of Colorado–Denver (CO)	www.ucdenver.edu
University of Colorado System (CO)	www.cu.edu
University of Connecticut (CT)	www.uconn.edu
University of Dallas (TX)	www.udallas.edu
University of Dayton (OH)	www.udayton.edu
University of Delaware (DE)	www.udel.edu
University of Denver (CO)	www.du.edu
University of the District of Columbia (DC)	www.udc.edu
University of Detroit Mercy (MI)	www.udmercy.edu
University of Dubuque (IA)	www.dbq.edu
University of Evansville (IN)	www.evansville.edu
The University of Findlay (OH)	www.findlay.edu
University of Florida (FL)	www.ufl.edu
University of Georgia (GA)	www.uga.edu
University of Great Falls (MT)	www.ugf.edu
University of Guam (GU)	www.uog.edu
University of Hartford (CT)	www.hartford.edu
University of Hawaii–Hilo (HI)	hilo.hawaii.edu
University of Hawaii–Manoa (HI)	manoa.hawaii.edu
University of Hawaii System (HI)	www.hawaii.edu
University of Hawaii–West O'ahu (HI)	www.uhwo.hawaii.edu
University of Houston (TX)	www.uh.edu
University of Houston–Clear Lake (TX)	www.uhcl.edu
University of Houston–Downtown (TX)	www.uhd.edu
University of Houston–Victoria (TX)	www.uhv.edu
University of Idaho (ID)	www.uidaho.edu
University of Illinois–Chicago (IL)	www.uic.edu
University of Illinois–Springfield (IL)	www.uis.edu
University of Illinois System (IL)	www.uic.edu
University of Illinois–Urbana-Champaign (IL)	illinois.edu
University of Indianapolis (IN)	www.uindy.edu
University of Iowa (IA)	www.uiowa.edu
University of Jamestown (ND)	www.uj.edu
University of Kansas (KS)	www.ku.edu
University of Kansas Medical Center (KS)	www.kumc.edu
University of Kentucky (KY)	www.uky.edu
University of La Verne (CA)	laverne.edu
University of Louisiana–Monroe (LA)	www.ulm.edu
University of Louisiana–Lafayette (LA)	www.louisiana.edu
University of Louisville (KY)	louisville.edu
University of Maine (ME)	umaine.edu
University of Maine–Augusta (ME)	www.uma.edu
University of Maine–Farmington (ME)	www.umf.maine.edu
University of Maine–Fort Kent (ME)	www.umfk.edu
University of Maine–Machias (ME)	machias.edu
University of Maine–Presque Isle (ME)	www.umpi.edu
University of Maine School of Law (ME)	mainelaw.maine.edu
University of Maine System (ME)	www.maine.edu
University of Mary (ND)	www.umary.edu
University of Mary Hardin-Baylor (TX)	www.umhb.edu
University of Mary Washington (VA)	www.umw.edu
University of Maryland–Baltimore	www.umaryland.edu
University of Maryland–Baltimore County	www.umbc.edu
University of Maryland–College Park	www.umd.edu
University of Maryland–Eastern Shore	www.umes.edu
University of Maryland–University College	www.umuc.edu
University of Massachusetts–Amherst (MA)	www.umass.edu
University of Massachusetts–Boston (MA)	www.umb.edu
University of Massachusetts–Dartmouth (MA)	www.umassd.edu
University of Massachusetts–Lowell (MA)	www.uml.edu
University of Massachusetts Medical School at Worcester (MA)	www.umassmed.edu
University of Massachusetts System (MA)	www.massachusetts.edu
University of Medicine & Dentistry of New Jersey (NJ)	www.umdnj.edu
University of Memphis (TN)	www.memphis.edu
University of Miami (FL)	www.miami.edu
University of Michigan (MI)	www.umich.edu
University of Michigan–Dearborn (MI)	umdearborn.edu
University of Michigan–Flint (MI)	www.umflint.edu
University of Minnesota–Crookston (MN)	www.crk.umn.edu
University of Minnesota–Duluth (MN)	www.d.umn.edu
University of Minnesota–Morris (MN)	www.morris.umn.edu
University of Minnesota–Rochester (MN)	www.r.umn.edu
University of Minnesota–Twin Cities (MN)	www.umn.edu
University of Mississippi (MS)	www.olemiss.edu
University of Mississippi Medical Center (MS)	www.umc.edu
University of Missouri (MO)	missouri.edu
University of Missouri–Kansas City (MO)	www.umkc.edu
University of Missouri–Saint Louis (MO)	www.umsl.edu
University of Missouri System (MO)	www.umsystem.edu
University of Mobile (AL)	www.umobile.edu
University of Montana–Missoula (MT)	www.umt.edu
University of Montana–Western (MT)	www.umwestern.edu
University of Montevallo (AL)	www.montevallo.edu
University of Mount Olive (NC)	www.umo.edu
University of Mount Union (OH)	www.mountunion.edu
University of Nebraska–Kearney (NE)	www.unk.edu
University of Nebraska–Lincoln (NE)	www.unl.edu
University of Nebraska Medical Center (NE)	www.unmc.edu
University of Nebraska–Omaha (NE)	www.unomaha.edu
University of Nebraska System (NE)	nebraska.edu
University of Nevada–Las Vegas (NV)	www.unlv.edu
University of Nevada–Reno (NV)	www.unr.edu
University of New England (ME)	www.une.edu
University of New Hampshire (NH)	www.unh.edu
University of New Hampshire at Manchester (NH)	manchester.unh.edu
University of New Hampshire School of Law (NH)	law.unh.edu
University of New Haven (CT)	www.newhaven.edu
University of New Mexico (NM)	www.unm.edu
University of New Orleans (LA)	www.uno.edu
University of North Alabama (AL)	www.una.edu
University of North Carolina–Asheville (NC)	www.unca.edu
University of North Carolina–Chapel Hill (NC)	unc.edu
University of North Carolina–Charlotte (NC)	www.uncc.edu
University of North Carolina–Greensboro (NC)	www.uncg.edu
University of North Carolina–Pembroke (NC)	www.uncp.edu
University of North Carolina–School of the Arts (NC)	www.uncsa.edu
University of North Carolina–Wilmington (NC)	uncw.edu
University of North Dakota (ND)	und.edu
University of North Florida (FL)	www.unf.edu
University of North Georgia (GA)	ung.edu
University of North Texas (TX)	www.unt.edu
University of North Texas Health Science Center (TX)	web.unthsc.edu
University of Northern Colorado (CO)	www.unco.edu
University of Northern Iowa (IA)	www.uni.edu
University of Northwestern Ohio (OH)	www.unoh.edu
University of Northwestern–Saint Paul (MN)	www.unwsp.edu
University of Notre Dame (IN)	nd.edu
University of Oklahoma (OK)	www.ou.edu
University of Oklahoma Health Sciences Center (OK)	www.ouhsc.edu
University of Oklahoma–Tulsa (OK)	www.ou.edu
University of Oregon (OR)	uoregon.edu
University of the Ozarks (AR)	www.ozarks.edu
Valdosta State University (GA)	www.valdosta.edu
Valencia College (FL)	valenciacollege.edu
Valley City State University (ND)	www.vcsu.edu
Valley Forge Christian College (PA)	www.vfcc.edu
Valparaiso University (IN)	www.valpo.edu
Vanderbilt University (TN)	www.vanderbilt.edu
VanderCook College of Music (IL)	www.vandercook.edu
Vanguard University of Southern California (CA)	www.vanguard.edu
Vassar College (NY)	www.vassar.edu
Vaughn College of Aeronautics & Technology (NY)	www.vaughn.edu
Vermont College of Fine Arts (VT)	vcfa.edu
Vermont Law School (VT)	www.vermontlaw.edu
Vermont Technical College (VT)	www.vtc.edu
Victory University (TN)	www.victory.edu
Villa Maria College (NY)	www.villa.edu
Villanova University (PA)	www.villanova.edu
Vincennes University (IN)	www.vinu.edu
Virginia Commonwealth University (VA)	www.vcu.edu
Virginia Intermont College (VA) (closed summer 2014)	www.vic.edu
Virginia Military Institute (VA)	www.vmi.edu
Virginia Polytechnic Institute & State University (VA)	www.vt.edu
Virginia State University (VA)	www.vsu.edu
Virginia Union University (VA)	www.vuu.edu
Virginia Wesleyan College (VA)	www.vwc.edu
Viterbo University (WI)	www.viterbo.edu
Voorhees College (SC)	voorhees.edu
Wabash College (IN)	www.wabash.edu
Wade College (TX)	www.wadecollege.edu
Wagner College (NY)	wagner.edu
Wake Forest University (NC)	www.wfu.edu
Walden University (MN)	www.waldenu.edu
Waldorf College (IA)	www.waldorf.edu
Walla Walla University (WA)	www.wallawalla.edu
Walsh College (MI)	www.walshcollege.edu
Walsh University (OH)	www.walsh.edu
Warner Pacific College (OR)	www.warnerpacific.edu
Warner University (FL)	warner.edu
Warren Wilson College (NC)	www.warren-wilson.edu
Wartburg College (IA)	www.wartburg.edu
Wartburg Theological Seminary (IA)	www.wartburgseminary.edu
Washburn University (KS)	www.washburn.edu
Washington & Jefferson College (PA)	www.washjeff.edu
Washington & Lee University (VA)	www.wlu.edu
Washington Adventist University (MD)	www.wau.edu
Washington Bible College/Capital Bible Seminary (MD)	www.bible.edu
Washington College (MD)	www.washcoll.edu
Washington State University (WA)	www.wsu.edu
Washington State University–Spokane (WA)	spokane.wsu.edu
Washington State University–Tri-Cities (WA)	www.tricity.wsu.edu
Washington State University–Vancouver (WA)	www.vancouver.wsu.edu
Washington Theological Union (DC)	www.wtu.edu
Washington University in Saint Louis (MO)	wustl.edu
Watkins College of Art, Design, & Film (TN)	www.watkins.edu
Wayland Baptist University (TX)	www.wbu.edu
Wayne State College (NE)	www.wsc.edu
Wayne State University (MI)	wayne.edu
Waynesburg University (PA)	www.waynesburg.edu
Webb Institute (NY)	www.webb.edu
Webber International University (FL)	webber.edu
Weber State University (UT)	www.weber.edu
Webster University (MO)	www.webster.edu
Welch College (TN)	www.welch.edu
Wellesley College (MA)	www.wellesley.edu
Wells College (NY)	www.wells.edu
Wentworth Institute of Technology (MA)	www.wit.edu
Wesley College (DE)	www.wesley.edu
Wesley Theological Seminary (DC)	www.wesleyseminary.edu
Wesleyan College (GA)	www.wesleyancollege.edu
Wesleyan University (CT)	www.wesleyan.edu
West Chester University of Pennsylvania (PA)	www.wcupa.edu
West Liberty University (WV)	westliberty.edu
West Texas A&M University (TX)	www.wtamu.edu
West Virginia State University (WV)	www.wvstateu.edu
West Virginia University (WV)	www.wvu.edu
West Virginia University Institute of Technology (WV)	www.wvutech.edu
West Virginia University at Parkersburg (WV)	www.wvup.edu
West Virginia Wesleyan College (WV)	www.wvwc.edu
Western Carolina University (NC)	www.wcu.edu
Western Connecticut State University (CT)	www.wcsu.edu
Western Governors University (UT)	www.wgu.edu
Western Governors University–Indiana (IN)	indiana.wgu.edu
Western Governors University–Missouri (MO)	missouri.wgu.edu
Western Governors University–Tennessee (TN)	tennessee.wgu.edu
Western Governors University–Texas (TX)	texas.wgu.edu
Western Governors University–Washington (WA)	washington.wgu.edu
Western Illinois University (IL)	www.wiu.edu
Western International University (AZ)	west.edu
Western Kentucky University (KY)	www.wku.edu
Western Michigan University (MI)	wmich.edu
Western Nevada College (NV)	www.wnc.edu
Western New England University (MA)	www.wne.edu
Western New Mexico University (NM)	wnmu.edu
Western Oregon University (OR)	www.wou.edu
Western Seminary (OR)	www.westernseminary.edu
Western State Colorado University (CO)	www.western.edu
Western State University College of Law (CA)	www.wsulaw.edu
Western University of Health Sciences (CA)	www.westernu.edu
Western Washington University (WA)	www.wwu.edu
Westfield State University (MA)	www.westfield.ma.edu
Westminster College (PA)	www.westminster.edu
Westminster College (MO)	www.westminster-mo.edu
Westminster College (UT)	www.westminstercollege.edu
Westminster Theological Seminary (PA)	www.wts.edu
Westminster Seminary California (CA)	www.wscal.edu
Westmont College (CA)	www.westmont.edu
Wheaton College (IL)	www.wheaton.edu
Wheaton College (MA)	wheatoncollege.edu
Wheeling Jesuit University (WV)	www.wju.edu
Wheelock College (MA)	www.wheelock.edu
Whitman College (WA)	www.whitman.edu
Whittier College (CA)	www.whittier.edu
Whitworth University (WA)	www.whitworth.edu
Wichita State University (KS)	www.wichita.edu
Widener University (PA)	www.widener.edu
Wilberforce University (OH)	www.wilberforce.edu
Wiley College (TX)	www.wileyc.edu
Wilkes University (PA)	www.wilkes.edu
Willamette University (OR)	www.willamette.edu
William Carey University (MS)	www.wmcarey.edu
William Jessup University (CA)	www.jessup.edu
William Jewell College (MO)	www.jewell.edu
William Penn University (IA)	www.wmpenn.edu
William Paterson University (NJ)	www.wpunj.edu
William Woods University (MO)	www.williamwoods.edu
Williams Baptist College (AR)	www.wbcoll.edu
Williams College (MA)	www.williams.edu
Wilmington University (DE)	www.wilmu.edu
Wilmington College (OH)	www.wilmington.edu
Wilson College (PA)	www.wilson.edu
Wingate University (NC)	www.wingate.edu
Winona State University (MN)	www.winona.edu
Winston-Salem State University (NC)	www.wssu.edu
Winthrop University (SC)	www.winthrop.edu
Wisconsin Lutheran College (WI)	www.wlc.edu
Wisconsin School of Professional Psychology (WI)	wspp.edu
Wittenberg University (OH)	www.wittenberg.edu
Wofford College (SC)	www.wofford.edu
Won Institute of Graduate Studies (PA)	www.woninstitute.edu
Woodbury University (CA)	www.woodbury.edu
Woods Hole Oceanographic Institution (MA)	www.whoi.edu
Worcester Polytechnic Institute (MA)	www.wpi.edu
Worcester State University (MA)	www.worcester.edu
The Wright Institute (CA)	www.wi.edu
Wright State University (OH)	www.wright.edu
Babson College (MA)	www.babson.edu
Bacone College (OK)	www.bacone.edu
Baldwin-Wallace College (OH)	www.bw.edu
Ball State University (IN)	cms.bsu.edu
Baker College (MI)	www.baker.edu
Baker University (KS)	www.bakeru.edu
Bangor Theological Seminary (ME) (closed 22 June 2013)	www.bts.edu
Bank Street College of Education (NY)	bankstreet.edu
Baptist Bible College (MO)	www.gobbc.edu
Baptist Bible College & Seminary (PA)	www.bbc.edu
The Baptist College of Florida (FL)	www.baptistcollege.edu
Baptist Memorial College of Health Sciences (TN)	www.bchs.edu
Baptist Missionary Association Theological Seminary (TX)	bmats.edu
Barclay College (KS)	www.barclaycollege.edu
Bard College (NY)	www.bard.edu
Bard College at Simon's Rock (MA)	simons-rock.edu
Barnard College (NY)	barnard.edu
Barry University (FL)	www.barry.edu
Barton College (NC)	www.barton.edu
Bastyr University (WA)	www.bastyr.edu
Bates College (ME)	www.bates.edu
Bauder College (GA)	www.bauder.edu
Bay Path College (MA)	www.baypath.edu
Bay State College (MA)	www.baystate.edu
Baylor College of Medicine (TX)	www.bcm.edu
Baylor University (TX)	www.baylor.edu
Beacon College (FL)	www.beaconcollege.edu
Becker College (MA)	www.becker.edu
Belhaven University (MS)	www.belhaven.edu
Bellarmine University (KY)	www.bellarmine.edu
Bellevue College (WA)	www.bellevuecollege.edu
Bellevue University (NE)	www.bellevue.edu
Bellin College (WI)	www.bellincollege.edu
Belmont University (TN)	www.belmont.edu
Belmont Abbey College (NC)	belmontabbeycollege.edu
Beloit College (WI)	www.beloit.edu
Bemidji State University (MN)	www.bemidjistate.edu
Benedict College (SC)	www.benedict.edu
Benedictine College (KS)	www.benedictine.edu
Benedictine University (IL)	www.ben.edu
Benjamin Franklin Institute of Technology (MA)	www.bfit.edu
Bennett College for Women (NC)	www.bennett.edu
Bennington College (VT)	www.bennington.edu
Bentley University (MA)	www.bentley.edu
Berea College (KY)	www.berea.edu
Berkeley College (NJ)	berkeleycollege.edu
Berklee College of Music (MA)	www.berklee.edu
Berry College (GA)	www.berry.edu
Bethany College (KS)	www.bethanylb.edu
Bethany College (WV)	www.bethanywv.edu
Bethany Lutheran College (MN)	www.blc.edu
Bethany Theological Seminary (IN)	www.bethanyseminary.edu
Bethel College (IN)	www.bethelcollege.edu
Bethel College (KS)	www.bethelks.edu
Bethel University & Seminary (MN)	www.bethel.edu
Bethel University (TN)	www.bethelu.edu
Bethesda University of California (CA)	buc.edu
Bethune-Cookman University (FL)	www.cookman.edu
Beulah Heights University (GA)	www.beulah.org
Biblical Theological Seminary (PA)	www.biblical.edu
Biola University (CA)	www.biola.edu
Birmingham-Southern College (AL)	www.bsc.edu
Bismark State College (ND)	www.bismarckstate.edu
Black Hills State University (SD)	www.bhsu.edu
Blackburn College (IL)	www.blackburn.edu
Blessing-Rieman College of Nursing (IL)	www.brcn.edu
Bloomfield College (NJ)	www.bloomfield.edu
Bloomsburg University of Pennsylvania (PA)	www.bloomu.edu
Blue Mountain College (MS)	www.bmc.edu
Bluefield College (VA)	www.bluefield.edu
Bluefield State College (WV)	bluefieldstate.edu
Bluffton University (OH)	www.bluffton.edu
Boise State University (ID)	www.boisestate.edu
Boricua College (NY)	www.boricuacollege.edu
Boston Architectural College (MA)	www.the-bac.edu
Boston College (MA)	www.bc.edu
Boston Conservatory (MA)	www.bostonconservatory.edu
Boston Graduate School of Psychoanalysis (MA)	www.bgsp.edu
Boston University (MA)	www.bu.edu
Bowdoin College (ME)	www.bowdoin.edu
Bowie State University (MD)	www.bowiestate.edu
Bowling Green State University (OH)	www.bgsu.edu
Bradley University (IL)	www.bradley.edu
Brandeis University (MA)	www.brandeis.edu
Brandman University (CA)	www.brandman.edu
Brenau University (GA)	www.brenau.edu
Brescia University (KY)	www.brescia.edu
Brevard College (NC)	www.brevard.edu
Brewton-Parker College (GA)	www.bpc.edu
Briar Cliff University (IA)	www.briarcliff.edu
Briarcliffe College (NY)	www.briarcliffe.edu
Bridgewater College (VA)	www.bridgewater.edu
Bridgewater State University (MA)	www.bridgew.edu
Brigham Young University (UT)	www.byu.edu
Brigham Young University–Hawaii (HI)	byuh.edu
Brigham Young University–Idaho (ID)	www.byui.edu
Brite Divinity School (TX)	brite.edu
Broward College (FL)	www.broward.edu
Brown University (RI)	www.brown.edu
Bryan College (TN)	www.bryan.edu
Bryan College of Health Sciences (NE)	www.bryanhealth.com
Bryant University (RI)	www.bryant.edu
Bryn Athyn College (PA)	www.brynathyn.edu
Bryn Mawr College (PA)	www.brynmawr.edu
Bucknell University (PA)	www.bucknell.edu
Buena Vista University (IA)	www.bvu.edu
Burlington College (VT)	www.burlington.edu
Butler University (IN)	www.butler.edu
Cabarrus College of Health Sciences (NC)	www.cabarruscollege.edu
Cabrini College (PA)	www.cabrini.edu
Cairn University (PA)	cairn.edu
Caldwell College (NJ)	www.caldwell.edu
California Baptist University (CA)	www.calbaptist.edu
California College of the Arts (CA)	www.cca.edu
California Institute of the Arts (CA)	calarts.edu
California Institute of Integral Studies (CA)	www.ciis.edu
California Institute of Technology (CA)	www.caltech.edu
California Lutheran University (CA)	www.callutheran.edu
California Maritime Academy (CA)	www.csum.edu
California Northstate University (CA)	www.cnsu.edu
California Polytechnic State University, San Luis Obispo (CA)	www.calpoly.edu
California State Polytechnic University, Pomona (CA)	www.csupomona.edu
California State University–Bakersfield (CA)	www.csub.edu
California State University–Channel Islands (CA)	www.csuci.edu
California State University–Chico (CA)	www.csuchico.edu
California State University–Dominguez Hills (CA)	www.csudh.edu
California State University–East Bay (CA)	www.csueastbay.edu
California State University–Fresno (CA)	www.fresnostate.edu
California State University–Fullerton (CA)	www.fullerton.edu
California State University–Long Beach (CA)	www.csulb.edu
California State University–Los Angeles (CA)	www.calstatela.edu
California State University–Monterey Bay (CA)	csumb.edu
California State University–Northridge (CA)	www.csun.edu
California State University–Sacramento (CA)	www.csus.edu
California State University–San Bernardino (CA)	www.csusb.edu
California State University–San Marcos (CA)	www.csusm.edu
California State University–Stanislaus (CA)	www.csustan.edu
California State University System (CA)	www.calstate.edu
California University of Pennsylvania (PA)	www.calu.edu
Calumet College of Saint Joseph (IN)	www.ccsj.edu
Calvary Baptist Seminary (PA)	www.cbs.edu
Calvary Bible College & Theological Seminary (MO)	www.calvary.edu
Calvin College (MI)	www.calvin.edu
Cambridge College (MA)	www.cambridgecollege.edu
Cameron University (OK)	www.cameron.edu
Campbell University (NC)	www.campbell.edu
Campbellsville University (KY)	www.campbellsville.edu
Canisius College (NY)	www.canisius.edu
Capella University (MN)	www.capella.edu
Capital University (OH)	www.capital.edu
Capitol College (MD)	www.capitol-college.edu
Cardinal Stritch University (WI)	www.stritch.edu
Caribbean University (PR)	www.caribbean.edu
Carleton College (MN)	www.carleton.edu
Carlos Albizu University (PR)	www.albizu.edu
Carlos Albizu University–Miami Campus (FL)	www.albizu.edu
Carlow University (PA)	www.carlow.edu
Carnegie Mellon University (PA)	www.cmu.edu
Carroll College (MT)	www.carroll.edu
Carroll University (WI)	www.carrollu.edu
Carson-Newman College (TN)	www.cn.edu
Carthage College (WI)	www.carthage.edu
Case Western Reserve University (OH)	www.case.edu
Castleton State College (VT)	www.castleton.edu
Catawba College (NC)	catawba.edu
Catholic Theological Union (IL)	www.ctu.edu
The Catholic University of America (DC)	www.cua.edu
Cazenovia College (NY)	www.cazenovia.edu
Cedar Crest College (PA)	www.cedarcrest.edu
Cedarville University (OH)	www.cedarville.edu
Centenary College (NJ)	www.centenarycollege.edu
Centenary College of Louisiana (LA)	www.centenary.edu
Central Baptist College (AR)	www.cbc.edu
Central Baptist Theological Seminary (KS)	www.cbts.edu
Central Christian College of Kansas (KS)	www.centralchristian.edu
Central Christian College of the Bible (MO)	www.cccb.edu
Central College (IA)	www.central.edu
Central Connecticut State University (CT)	www.ccsu.edu
Central Methodist University (MO)	www.centralmethodist.edu
Central Michigan University (MI)	www.cmich.edu
Central Penn College (PA)	www.centralpenn.edu
Central State University (OH)	www.centralstate.edu
Central Washington University (WA)	www.cwu.edu
Centre College (KY)	www.centre.edu
Centro de Estudios Avanzados de Puerto Rico y el Caribe (PR)	www.ceaprc.edu
Chadron State College (NE)	www.csc.edu
Chamberlain College of Nursing (IL)	www.chamberlain.edu
Chaminade University (HI)	www.chaminade.edu
Champlain College (VT)	www.champlain.edu
Chancellor University (OH)	www.chancelloru.edu
Chapman University (CA)	www.chapman.edu
Charles R. Drew University of Medicine & Science (CA)	www.cdrewu.edu
Charleston Southern University (SC)	www.csuniv.edu
Charter Oak State College (CT)	www.charteroak.edu
Chester College of New England (NH) (closed May 2012)	en.wikipedia.org
Chestnut Hill College (PA)	www.chc.edu
Cheyney University (PA)	www.cheyney.edu
The Chicago School of Professional Psychology (IL)	www.thechicagoschool.edu
Chicago State University (IL)	www.csu.edu
Chicago Theological Seminary (IL)	www.ctschicago.edu
Chipola College (FL)	www.chipola.edu
Chowan College (NC)	www.chowan.edu
Christ the King Seminary (NY)	www.cks.edu
Christendom College (VA)	www.christendom.edu
Christian Brothers University (TN)	www.cbu.edu
Christian Theological Seminary (IN)	www.cts.edu
Christopher Newport University (VA)	cnu.edu
Church Divinity School of the Pacific (CA)	cdsp.edu
Cincinnati Christian University (OH)	www.ccuniversity.edu
Cincinnati College of Mortuary Science	www.ccms.edu
The Citadel (SC)	www.citadel.edu
City University of Seattle (WA)	www.cityu.edu
City University of New York (NY)	www.cuny.edu
City University of New York (NY) Baruch College	www.baruch.cuny.edu
City University of New York (NY) Brooklyn College	www.brooklyn.cuny.edu
City University of New York (NY) City College	www.ccny.cuny.edu
City University of New York (NY) College of Staten Island	www.csi.cuny.edu
City University of New York (NY) Graduate School & University Center	www.gc.cuny.edu
City University of New York (NY) Hunter College	www.hunter.cuny.edu
City University of New York (NY) John Jay College of Criminal Justice	www.jjay.cuny.edu
City University of New York (NY) Lehman College	www.lehman.cuny.edu
City University of New York (NY) Medgar Evers College	www.mec.cuny.edu
City University of New York (NY) New York City College of Technology	www.citytech.cuny.edu
City University of New York (NY) Queens College	www.qc.cuny.edu
City University of New York (NY) York College	www.york.cuny.edu
Claflin University (SC)	www.claflin.edu
Claremont Consortium of Colleges (CA)	www.claremont.edu
Claremont Consortium of Colleges (CA) Claremont Graduate University	www.cgu.edu
Claremont Consortium of Colleges (CA) Claremont McKenna College	www.claremont.edu
Claremont Consortium of Colleges (CA) Harvey Mudd College	www.hmc.edu
Claremont Consortium of Colleges (CA) Keck Graduate Institute of Applied Life Sciences	www.kgi.edu
Claremont Consortium of Colleges (CA) Pitzer College	www.pitzer.edu
Claremont Consortium of Colleges (CA) Pomona College	en.wikipedia.org
Claremont Consortium of Colleges (CA) Scripps College	www.scrippscollege.edu
Claremont School of Theology (CA)	www.cst.edu
Clarion University of Pennsylvania (PA)	www.clarion.edu
Clark University (MA)	www.clarku.edu
Clark Atlanta University (GA)	www.cau.edu
Clarke University (IA)	www.clarke.edu
Clarkson College (NE)	www.clarksoncollege.edu
Clarkson University (NY)	www.clarkson.edu
Clayton State University (GA)	www.clayton.edu
Clear Creek Baptist Bible College (KY)	www.ccbbc.edu
Clearwater Christian College (FL)	www.clearwater.edu
Cleary University (MI)	www.cleary.edu
Clemson University (SC)	www.clemson.edu
Cleveland Chiropractic College (KS)	www.cleveland.edu
Cleveland Institute of Art (OH)	www.cia.edu
Cleveland Institute of Music (OH)	www.cim.edu
Cleveland State University (OH)	www.csuohio.edu
Coastal Carolina University (SC)	www.coastal.edu
Coe College (IA)	www.coe.edu
Cogswell Polytechnical College (CA)	www.cogswell.edu
Coker College (SC)	www.coker.edu
Colby College (ME)	www.colby.edu
Colby-Sawyer College (NH)	www.colby-sawyer.edu
Colegio Universitario de San Juan (PR)	www.cunisanjuan.edu
Colgate University (NY)	www.colgate.edu
College for Creative Studies (MI)	www.collegeforcreativestudies.edu
College for Financial Planning (CO)	www.cffp.edu
College of the Atlantic (ME)	www.coa.edu
College of Biblical Studies–Houston (TX)	cbshouston.edu
College of Central Florida (FL)	www.cf.edu
College of Charleston (SC)	www.cofc.edu
College of Coastal Georgia (GA)	www.ccga.edu
College of the Holy Cross (MA)	www.holycross.edu
The College of Idaho (ID)	www.collegeofidaho.edu
College of the Menominee Nation (WI)	www.menominee.edu
College of Mount Saint Joseph (OH)	www.msj.edu
College of Mount Saint Vincent (NY)	www.mountsaintvincent.edu
The College of New Jersey (NJ)	tcnj.pages.tcnj.edu
College of New Rochelle (NY)	www.cnr.edu
College of Notre Dame of Maryland (MD)	www.ndm.edu
College of the Ozarks (MO)	www.cofo.edu
College of Saint Benedict (MN)	www.csbsju.edu
College of Saint Elizabeth (NJ)	www.cse.edu
College of Saint Rose (NY)	www.strose.edu
College of Saint Joseph (VT)	www.csj.edu
College of Saint Mary (NE)	www.csm.edu
College of Saint Scholastica (MN)	www.css.edu
College of Saints John Fisher & Thomas More (TX)	fishermore.edu
College of Southern Nevada (NV)	www.csn.edu
College of Visual Arts (MN) (closed 30 June 2013)	en.wikipedia.org
College of William and Mary (VA)	www.wm.edu
College of Wooster (OH)	www.wooster.edu
Colorado Christian University (CO)	www.ccu.edu
Colorado College (CO)	www.coloradocollege.edu
Colorado Mesa University (CO)	www.coloradomesa.edu
Colorado School of Mines (CO)	www.mines.edu
Colorado State University (CO)	www.colostate.edu
Colorado State University–Pueblo (CO)	www.colostate-pueblo.edu
Colorado Technical University (CO)	www.coloradotech.edu
Columbia Centro Universitario (PR)	www.columbiaco.edu
Columbia College (MO)	www.ccis.edu
Columbia College (SC)	www.columbiasc.edu
Columbia College Chicago (IL)	www.colum.edu
Columbia College of Nursing (WI)	www.ccon.edu
Columbia International University (SC)	www.ciu.edu
Columbia Theological Seminary (GA)	www.ctsnet.edu
Columbia University (NY)	www.columbia.edu
Columbus College of Art & Design (OH)	www.ccad.edu
Columbus State University (GA)	www.columbusstate.edu
Conception Seminary College (MO)	www.conception.edu
Concord University (WV)	www.concord.edu
Concordia College–Alabama (AL)	www.ccal.edu
Concordia College–Bronxville (NY)	www.concordia-ny.edu
Concordia College–Moorhead (MN)	www.concordiacollege.edu
Concordia College–New York (NY)	www.concordia-ny.edu
Concordia Seminary–Saint Louis (MO)	www.csl.edu
Concordia Theological Seminary (IN)	www.ctsfw.edu
Concordia University–Ann Arbor (MI)	www.cuaa.edu
Concordia University–Chicago (IL)	www.cuchicago.edu
Concordia University–Irvine (CA)	www.cui.edu
Concordia University–Nebraska (NE)	www.cune.edu
Concordia University–Portland (OR)	www.cu-portland.edu
Concordia University–Saint Paul (MN)	www.csp.edu
Concordia University–Texas (TX)	www.concordia.edu
Concordia University–Wisconsin (WI)	www.cuw.edu
Connecticut College (CT)	www.conncoll.edu
Conservatorio de Música de Puerto Rico (PR)	cmpr.edu
Converse College (SC)	www.converse.edu
Conway School of Landscape Design (MA)	www.csld.edu
The Cooper Union for the Advancement of Science & Art (NY)	www.cooper.edu
Coppin State University (MD)	www.coppin.edu
Corban University (OR)	www.corban.edu
Corcoran College of Art & Design (DC)	www.corcoran.org
Cornell College (IA)	www.cornellcollege.edu
Cornell University (NY)	www.cornell.edu
Cornerstone University (MI)	www.cornerstone.edu
Cornish College of the Arts (WA)	www.cornish.edu
Cottey College (MO)	www.cottey.edu
Covenant College (GA)	www.covenant.edu
Covenant Theological Seminary (MO)	www.covenantseminary.edu
Cox College (MO)	www.coxcollege.edu
Cranbrook Academy of Art (MI)	www.cranbrookart.edu
Creighton University (NE)	www.creighton.edu
Criswell College (TX)	www.criswell.edu
Crossroads College (MN)	www.crossroadscollege.edu
Crowley's Ridge College (AR)	www.crc.edu
Crown College (MN)	www.crown.edu
Culinary Institute of America (NY)	www.ciachef.edu
Culver-Stockton College (MO)	www.culver.edu
Cumberland University (TN)	www.cumberland.edu
Curry College (MA)	www.curry.edu
Curtis Institute of Music (PA)	www.curtis.edu
Hamilton College (NY)	www.hamilton.edu
Hamline University (MN)	www.hamline.edu
Hampden-Sydney College (VA)	www.hsc.edu
Hampshire College (MA)	www.hampshire.edu
Hampton University (VA)	www.hamptonu.edu
Hannibal-Lagrange College (MO)	www.hlg.edu
Hanover College (IN)	www.hanover.edu
Hardin-Simmons University (TX)	www.hsutx.edu
Harding University (AR)	www.harding.edu
Harrington College of Design (IL)	www.harrington.edu
Harris-Stowe State University (MO)	www.hssu.edu
Harrisburg University of Science & Technology (PA)	www.harrisburgu.edu
Hartford Seminary (CT)	www.hartsem.edu
Hartwick College (NY)	www.hartwick.edu
Harvard University (MA)	www.harvard.edu
Haskell Indian Nations University (KS)	www.haskell.edu
Hastings College (NE)	www.hastings.edu
Haverford College (PA)	www.haverford.edu
Hawaii Pacific University (HI)	www.hpu.edu
Hazelden Graduate School of Addiction Studies (MN)	www.hazelden.org
Hebrew College (MA)	www.hebrewcollege.edu
Hebrew Theological College (IL)	www.htc.edu
Hebrew Union College–Jewish Institute of Religion (CA / OH / NY)	huc.edu
Heidelberg College (OH)	www.heidelberg.edu
Hellenic College/Holy Cross Greek Orthodox School of Theology (MA)	www.hchc.edu
Henderson State University (AR)	www.hsu.edu
Hendrix College (AR)	www.hendrix.edu
Heritage University (WA)	www.heritage.edu
Herzing University (WI)	www.herzing.edu
High Point University (NC)	www.highpoint.edu
Hilbert College (NY)	www.hilbert.edu
Hillsdale College (MI)	www.hillsdale.edu
Hiram College (OH)	www.hiram.edu
Hobart & William Smith Colleges (NY)	www.hws.edu
Hobe Sound Bible College (FL)	hsbc.edu
Hodges University (FL)	www.hodges.edu
Hofstra University (NY)	www.hofstra.edu
Hollins University (VA)	www.hollins.edu
Holy Apostles College & Seminary (CT)	www.holyapostles.edu
Holy Cross College (IN)	www.hcc-nd.edu
Holy Family University (PA)	www.holyfamily.edu
Holy Names University (CA)	www.hnu.edu
Hood College (MD)	www.hood.edu
Hope College (MI)	www.hope.edu
Hope International University (CA)	www.hiu.edu
Houghton College (NY)	www.houghton.edu
Houston Baptist University (TX)	www.hbu.edu
Howard Payne University (TX)	www.hputx.edu
Howard University (DC)	www.howard.edu
Hult International Business School (MA)	www.hult.edu
Humboldt State University (CA)	www.humboldt.edu
Humphreys College (CA)	www.humphreys.edu
Huntingdon College (AL)	www.huntingdon.edu
Huntington University (IN)	www.huntington.edu
Husson University (ME)	www.husson.edu
Huston-Tillotson University (TX)	htu.edu
Kalamazoo College (MI)	www.kzoo.edu
Kansas City Art Institute (MO)	www.kcai.edu
Kansas City University of Medicine & Biosciences (MO)	www.kcumb.edu
Kansas State University (KS)	www.k-state.edu
Kansas State University–Salina (KS)	salina.k-state.edu
Kansas Wesleyan University (KS)	www.kwu.edu
Kaplan University (IA)	www.kaplanuniversity.edu
Kean University (NJ)	www.kean.edu
Keene State College (NH)	www.keene.edu
Keiser University (FL)	www.keiseruniversity.edu
Kendall College (IL)	www.kendall.edu
Kendall College of Art & Design of Ferris State University (MI)	www.kcad.edu
Kennesaw State University (GA)	www.kennesaw.edu
Kenrick-Glennon Seminary (MO)	www.kenrick.edu
Kent State University (OH)	www.kent.edu
Kent State University–Ashtabula Campus (OH)	www.ashtabula.kent.edu
Kent State University–College of Podiatric Medicine (OH)	www.kent.edu
Kent State University–Columbiana County (OH)	www.salem.kent.edu
Kent State University–Geauga (OH)	www.geauga.kent.edu
Kent State University–Stark (OH)	www.stark.kent.edu
Kent State University–Trumbull Campus (OH)	www.trumbull.kent.edu
Kent State University–Tuscarawas (OH)	www.tusc.kent.edu
Kentucky Christian University (KY)	www.kcu.edu
Kentucky Mountain Bible College (KY)	www.kmbc.edu
Kentucky State University (KY)	kysu.edu
Kentucky Wesleyan College (KY)	www.kwc.edu
Kenyon College (OH)	www.kenyon.edu
Kettering College (OH)	www.kc.edu
Kettering University (MI)	www.kettering.edu
Keuka College (NY)	keuka.edu
Keystone College (PA)	www.keystone.edu
King College (TN)	www.king.edu
King's College (PA)	www.kings.edu
The King's College (NY)	www.tkc.edu
Knowledge Systems Institute (IL)	www.ksi.edu
Knox College (IL)	www.knox.edu
Kutztown University of Pennsylvania (PA)	www2.kutztown.edu
Kuyper College (MI)	www.kuyper.edu
Macalester College (MN)	www.macalester.edu
MacMurray College (IL)	www.mac.edu
Madonna University (MI)	www.madonna.edu
Maharishi University of Management (IA)	www.mum.edu
Maine College of Art (ME)	www.meca.edu
Maine Maritime Academy (ME)	www.mainemaritime.edu
Malone University (OH)	www.malone.edu
Manchester University (IN)	www.manchester.edu
Manhattan Christian College (KS)	www.mccks.edu
Manhattan College (NY)	manhattan.edu
Manhattan School of Music (NY)	www.msmnyc.edu
Manhattanville College (NY)	www.mville.edu
Mansfield University of Pennsylvania (PA)	www.mansfield.edu
Maranatha Baptist University (WI)	www.mbu.edu
Maria College of Albany (NY)	www.mariacollege.edu
Marian University (IN)	www.marian.edu
Marian University (WI)	www.marianuniversity.edu
Marietta College (OH)	www.marietta.edu
Marine Corps University (VA)	www.mcu.usmc.mil
Marist College (NY)	www.marist.edu
Marlboro College (VT)	www.marlboro.edu
Marquette University (WI)	www.marquette.edu
Mars Hill College (NC)	www.mhu.edu
Marshall University (WV)	www.marshall.edu
Martin Luther College (MN)	www.mlc-wels.edu
Martin Methodist College (TN)	www.martinmethodist.edu
Martin University (IN)	www.martin.edu
Mary Baldwin College (VA)	www.mbc.edu
Marygrove College (MI)	www.marygrove.edu
Maryland Institute College of Art (MD)	www.mica.edu
Maryland University of Integrative Health (MD)	www.muih.edu
Marylhurst University (OR)	www.marylhurst.edu
Marymount California University (CA)	www.marymountcalifornia.edu
Marymount Manhattan College (NY)	www.mmm.edu
Marymount University (VA)	www.marymount.edu
Maryville College (TN)	www.maryvillecollege.edu
Maryville University of Saint Louis (MO)	www.maryville.edu
Marywood University (PA)	www.marywood.edu
Massachusetts College of Art & Design (MA)	www.massart.edu
Massachusetts College of Liberal Arts (MA)	www.mcla.edu
Massachusetts College of Pharmacy & Health Sciences (MA)	www.mcphs.edu
Massachusetts Institute of Technology (MA)	web.mit.edu
Massachusetts Maritime Academy (MA)	www.maritime.edu
Massachusetts School of Law (MA)	mslaw.edu
Massachusetts School of Professional Psychology (MA)	www.mspp.edu
The Master's College (CA)	www.masters.edu
The Master's Seminary (CA)	www.tms.edu
Maui College (HI)	maui.hawaii.edu
Mayo Clinic College of Medicine (MN)	www.mayo.edu
Mayo Clinic College of Medicine–Graduate School	www.mayo.edu
Mayo Clinic College of Medicine–Medical School	www.mayo.edu
Mayo Clinic College of Medicine–School of Health Sciences	www.mayo.edu
Mayville State University (ND)	www.mayvillestate.edu
McCormick Theological Seminary (IL)	mccormick.edu
McDaniel College (MD)	www.mcdaniel.edu
McKendree University (IL)	www.mckendree.edu
McMurry University (TX)	ww2.mcm.edu
McNeese State University (LA)	www.mcneese.edu
McPherson College (KS)	www.mcpherson.edu
Medaille College (NY)	www.medaille.edu
Medical College of Wisconsin (WI)	www.mcw.edu
Medical University of South Carolina (SC)	www.musc.edu
Meharry Medical College (TN)	www.mmc.edu
Memphis College of Art (TN)	mca.edu
Memphis Theological Seminary (TN)	www.memphisseminary.edu
Menlo College (CA)	www.menlo.edu
Mercer University (GA)	www.mercer.edu
Mercy College (NY)	www.mercy.edu
Mercy College of Health Sciences (IA)	www.mchs.edu
Mercy College of Northwest Ohio (OH)	www.mercycollege.edu
Mercyhurst College (PA)	www.mercyhurst.edu
Meredith College (NC)	www.meredith.edu
Merrimack College (MA)	www.merrimack.edu
Messiah College (PA)	www.messiah.edu
Methodist College (IL)	www.methodistcol.edu
Methodist Theological School in Ohio (OH)	www.mtso.edu
Methodist University (NC)	www.methodist.edu
Metropolitan College of New York (NY)	www.mcny.edu
Metropolitan State University (MN)	www.metrostate.edu
Metropolitan State University of Denver (CO)	www.msudenver.edu
MGH Institute of Health Professions (MA)	www.mghihp.edu
Miami Dade College (FL)	www.mdc.edu
Miami International University of Art & Design (FL)	new.artinstitutes.edu
Miami University (OH)	miamioh.edu
Miami University–Regional Campuses (OH)	www.regionals.miamioh.edu
Michigan School of Professional Psychology (MI)	mispp.edu
Michigan State University (MI)	www.msu.edu
Michigan Technological University (MI)	www.mtu.edu
Mid-America Baptist Theological Seminary (TN)	www.mabts.edu
Mid-America Christian University (OK)	www.macu.edu
Mid-Atlantic Christian University (NC)	www.macuniversity.edu
MidAmerica Nazarene University (KS)	www.mnu.edu
Mid-Continent University (KY)	www.midcontinent.edu
Middle Georgia State College (GA)	www.mga.edu
Middle Tennessee School of Anesthesia (TN)	www.mtsa.edu
Middle Tennessee State University (TN)	www.mtsu.edu
Middlebury College (VT)	www.middlebury.edu
Midland University (NE)	www.midlandu.edu
Midstate College (IL)	www.midstate.edu
Midway College (KY)	www.midway.edu
Midwestern Baptist Theological Seminary (MO)	www.mbts.edu
Midwestern University (IL / AZ)	www.midwestern.edu
Midwestern State University (TX)	www.mwsu.edu
Miles College (AL)	www.miles.edu
Miller College (MI)	www.millercollege.edu
Millersville University of Pennsylvania (PA)	www.millersville.edu
Milligan College (TN)	www.milligan.edu
Millikin University (IL)	www.millikin.edu
Mills College (CA)	www.mills.edu
Millsaps College (MS)	www.millsaps.edu
Milwaukee Institute of Art & Design (WI)	www.miad.edu
Milwaukee School of Engineering (WI)	www.msoe.edu
Minnesota State University–Mankato (MN)	www.mnsu.edu
Minnesota State University–Moorhead (MN)	www.mnstate.edu
Minot State University (ND)	www.minotstateu.edu
Minneapolis College of Art & Design (MN)	mcad.edu
Misericordia University (PA)	www.misericordia.edu
Mississippi College (MS)	www.mc.edu
Mississippi State University (MS)	www.msstate.edu
Mississippi University for Women (MS)	www.muw.edu
Mississippi Valley State University (MS)	www.mvsu.edu
Missouri Baptist University (MO)	www.mobap.edu
Missouri Southern State University (MO)	www.mssu.edu
Missouri State University (MO)	www.missouristate.edu
Missouri University of Science & Technology (MO)	www.mst.edu
Missouri Valley College (MO)	www.moval.edu
Missouri Western State University (MO)	www.missouriwestern.edu
Mitchell College (CT)	www.mitchell.edu
Molloy College (NY)	www.molloy.edu
Monmouth College (IL)	www.monmouthcollege.edu
Monmouth University (NJ)	www.monmouth.edu
Monroe College (NY)	www.monroecollege.edu
Montana State University (MT)	www.montana.edu
Montana State University–Billings (MT)	www.msubillings.edu
Montana State University–Northern (MT)	www.msun.edu
Montana Tech of The University of Montana (MT)	www.mtech.edu
Montclair State University (NJ)	www.montclair.edu
Montreat College (NC)	www.montreat.edu
Montserrat College of Art (MA)	www.montserrat.edu
Moody Bible Institute (IL)	www.moody.edu
Moore College of Art & Design (PA)	moore.edu
Moravian College (PA)	www.moravian.edu
Morehead State University (KY)	www.moreheadstate.edu
Morehouse College (GA)	www.morehouse.edu
Morehouse School of Medicine (GA)	www.msm.edu
Morgan State University (MD)	www.morgan.edu
Morningside College (IA)	www.morningside.edu
Morris College (SC)	www.morris.edu
Mount Aloysius College (PA)	www.mtaloy.edu
Mount Angel Seminary (OR)	www.mountangelabbey.org
Mount Carmel College of Nursing (OH)	www.mccn.edu
Mount Holyoke College (MA)	www.mtholyoke.edu
Mount Ida College (MA)	www.mountida.edu
Mount Marty College (SD)	www.mtmc.edu
Mount Mary College (WI)	www.mtmary.edu
Mount Mercy University (IA)	www.mtmercy.edu
Mount Saint Mary College (NY)	www.msmc.edu
Mount Saint Mary's College (CA)	www.msmc.la.edu
Mount Saint Mary's University (MD)	www.msmary.edu
Mount Vernon Nazarene University (OH)	www.mvnu.edu
Mount Washington College (NH)	www.mountwashington.edu
Mountain State University (WV) (closed 01 January 2013)	en.wikipedia.org
Muhlenberg College (PA)	www.muhlenberg.edu
Multnomah University (OR)	www.multnomah.edu
Murray State University (KY)	www.murraystate.edu
Muskingum University (OH)	www.muskingum.edu
Pace University (NY)	www.pace.edu
Pacific Lutheran University (WA)	www.plu.edu
Pacific Northwest College of Art (OR)	www.pnca.edu
Pacific Oaks College (CA)	www.pacificoaks.edu
Pacific School of Religion (CA)	www.psr.edu
Pacific Union College (CA)	www.puc.edu
Pacific University (OR)	www.pacificu.edu
Pacifica Graduate Institute (CA)	www.pacifica.edu
Paine College (GA)	www.paine.edu
Palm Beach Atlantic University (FL)	www.pba.edu
Palm Beach State College (FL)	www.palmbeachstate.edu
Palmer College of Chiropractic (IA)	www.palmer.edu
Palo Alto University (CA)	www.paloaltou.edu
Pardee RAND Graduate School (CA)	www.prgs.edu
Park University (MO)	www.park.edu
Parker University (TX)	www.parker.edu
Patten University (CA)	patten.edu
Paul Quinn College (TX)	www.pqc.edu
Paul Smith's College (NY)	www.paulsmiths.edu
Peace College (NC)	www.peace.edu
Peirce College (PA)	www.peirce.edu
Peninsula College (WA)	www.pencol.edu
Pennsylvania College of Art & Design (PA)	www.pcad.edu
Pennsylvania College of Health Sciences (PA)	www.pacollege.edu
Pennsylvania College of Technology (PA)	www.pct.edu
Pennsylvania State University (PA)	www.psu.edu
Pennsylvania State University–Abington (PA)	www.abington.psu.edu
Pennsylvania State University–Altoona (PA)	www.altoona.psu.edu
Pennsylvania State University–Beaver (PA)	beaver.psu.edu
Pennsylvania State University–Berks (PA)	berks.psu.edu
Pennsylvania State University–Brandywine (PA)	brandywine.psu.edu
Pennsylvania State University–Dickinson School of Law (PA)	law.psu.edu
Pennsylvania State University–DuBois (PA)	dubois.psu.edu
Pennsylvania State University–Erie, The Behrend College (PA)	psbehrend.psu.edu
Pennsylvania State University–Fayette, The Eberly Campus (PA)	www.fe.psu.edu
Pennsylvania State University–Great Valley School of Graduate Professional Studies (PA)	www.sgps.psu.edu
Pennsylvania State University–Greater Allegheny (PA)	www.ga.psu.edu
Pennsylvania State University–Harrisburg (PA)	hbg.psu.edu
Pennsylvania State University–Hazleton (PA)	hazleton.psu.edu
Pennsylvania State University–Lehigh Valley (PA)	www.lv.psu.edu
Pennsylvania State University–Milton S. Hershey Medical Center (PA)	www.pennstatehershey.org
Pennsylvania State University–Mont Alto (PA)	montalto.psu.edu
Pennsylvania State University–New Kensington (PA)	nk.psu.edu
Pennsylvania State University–Schuylkill (PA)	www.sl.psu.edu
Pennsylvania State University–Shenango (PA)	www.shenango.psu.edu
Pennsylvania State University–Wilkes-Barre (PA)	wb.psu.edu
Pennsylvania State University–Worthington Scranton (PA)	worthingtonscranton.psu.edu
Pennsylvania State University–York (PA)	www.yk.psu.edu
Pensacola State College (FL)	www.pensacolastate.edu
Pentecostal Theological Seminary (TN)	www.ptseminary.net
Pepperdine University (CA)	www.pepperdine.edu
Peru State College (NE)	www.peru.edu
Pfeiffer University (NC)	www.pfeiffer.edu
Philadelphia College of Osteopathic Medicine (PA)	www.pcom.edu
Philadelphia College of Textiles & Science (PA)	www.philau.edu
Philander Smith College (AR)	www.philander.edu
Phillips Graduate Institute (CA)	pgi.edu
Phillips Theological Seminary (OK)	ptstulsa.edu
Phillips University (OK) (closed July 1998)	www.pulf.org
Piedmont College (GA)	www.piedmont.edu
Pillar College (NJ)	www.pillar.edu
Pine Manor College (MA)	www.pmc.edu
Pittsburg State University (KS)	www.pittstate.edu
Pittsburgh Theological Seminary (PA)	www.pts.edu
Plymouth State University (NH)	www.plymouth.edu
Point Loma Nazarene University (CA)	www.pointloma.edu
Point Park University (PA)	www.pointpark.edu
Point University (GA)	point.edu
Polk State College (FL)	www.polk.edu
Ponce School of Medicine & Health Sciences (PR)	www.psm.edu
Pontifical College Josephinum (OH)	www.pcj.edu
Pontificia Universidad Católica de Puerto Rico (PR)	en.wikipedia.org
Portland State University (OR)	www.pdx.edu
Post University (CT)	www.post.edu
Prairie View A&M University (TX)	www.pvamu.edu
Pratt Institute (NY)	www.pratt.edu
Prescott College (AZ)	www.prescott.edu
Presentation College (SD)	www.presentation.edu
Princeton Theological Seminary (NJ)	www.ptsem.edu
Princeton University (NJ)	www.princeton.edu
Principia College (IL)	www.principiacollege.edu
Presbyterian College (SC)	www.presby.edu
Providence College (RI)	www.providence.edu
Purdue University (IN)	www.purdue.edu
Purdue University–Calumet (IN)	webs.purduecal.edu
Purdue University–North Central (IN)	www.pnc.edu
Purdue University College of Technology–Anderson (IN)	tech.purdue.edu
Purdue University College of Technology–Columbus (IN)	tech.purdue.edu
Purdue University College of Technology–Indianapolis (IN)	tech.purdue.edu
Purdue University College of Technology–Kokomo (IN)	tech.purdue.edu
Purdue University College of Technology–Lafayette (IN)	tech.purdue.edu
Purdue University College of Technology–New Albany (IN)	tech.purdue.edu
Purdue University College of Technology–Richmond (IN)	tech.purdue.edu
Purdue University College of Technology–South Bend (IN)	tech.purdue.edu
Sacred Heart Major Seminary (MI)	www.shms.edu
Sacred Heart School of Theology (WI)	www.shst.edu
Sacred Heart University (CT)	www.sacredheart.edu
The Sage Colleges (NY)	www.sage.edu
Saginaw Valley State University (MI)	www.svsu.edu
Saint Ambrose University (IA)	www.sau.edu
Saint Andrews Presbyterian College (NC)	www.sapc.edu
Saint Anselm College (NH)	www.anselm.edu
Saint Anthony College of Nursing (IL)	sacn.edu
Saint Augustine College (IL)	www.staugustine.edu
Saint Augustine's University (NC)	www.st-aug.edu
Saint Bonaventure University (NY)	www.sbu.edu
Saint Catherine University (MN)	www.stkate.edu
Saint Catharine College (KY)	www.sccky.edu
Saint Charles Borromeo Seminary (PA)	www.scs.edu
Saint Cloud State University (MN)	www.stcloudstate.edu
Saint Edward's University (TX)	www.stedwards.edu
Saint Francis College (NY)	www.sfc.edu
Saint Francis Medical Center College of Nursing (IL)	www.sfmccon.edu
Saint Francis University (PA)	francis.edu
Saint Gregory the Great Seminary (NE)	www.stgregoryseminary.org
Saint Gregory's University (OK)	www.stgregorys.edu
Saint John Fisher College (NY)	www.sjfc.edu
Saint John Vianney College Seminary (FL)	www.sjvcs.edu
Saint John's College–Annapolis (MD)	www.sjc.edu
Saint John's College–Santa Fe (NM)	www.sjc.edu
Saint John's College (IL)	stjohnscollegespringfield.edu
Saint John's Seminary (CA)	www.stjohnsem.edu
Saint John's Seminary (MA)	www.sjs.edu
Saint John's University (MN)	www.csbsju.edu
Saint John's University (NY)	www.stjohns.edu
Saint Johns River State College (FL)	www.sjrstate.edu
Saint Joseph Seminary College (LA)	saintjosephabbey.com
Saint Joseph's College (IN)	www.saintjoe.edu
Saint Joseph's College (NY)	www.sjcny.edu
Saint Joseph's College of Maine (ME)	www.sjcme.edu
Saint Joseph's Seminary (NY)	dunwoodie.edu
Saint Joseph's University (PA)	www.sju.edu
Saint Lawrence University (NY)	www.stlawu.edu
Saint Leo University (FL)	www.saintleo.edu
Saint Louis College of Pharmacy (MO)	www.stlcop.edu
Saint Louis University (MO)	www.slu.edu
Saint Luke's College (IA)	www.stlukescollege.edu
Saint Luke's College of Health Sciences (MO)	saintlukescollege.edu
Saint Martin's University (WA)	www.stmartin.edu
Saint Mary Seminary & Graduate School of Theology (OH)	www.stmarysem.edu
Saint Mary-of-the-Woods College (IN)	www.smwc.edu
Saint Mary's College (IN)	www.saintmarys.edu
Saint Mary's College of California (CA)	www.stmarys-ca.edu
Saint Mary's College of Maryland (MD)	www.smcm.edu
Saint Mary's Seminary & University (MD)	www.stmarys.edu
Saint Mary's University of Minnesota (MN)	www.smumn.edu
Saint Mary's University (TX)	www.stmarytx.edu
Saint Meinrad Seminary & School of Theology (IN)	www.saintmeinrad.edu
Saint Michael's College (VT)	www.smcvt.edu
Saint Norbert College (WI)	www.snc.edu
Saint Olaf College (MN)	wp.stolaf.edu
Saint Patrick's Seminary & University (CA)	www.stpatricksseminary.org
Saint Paul School of Theology (MO)	www.spst.edu
Saint Paul's College (VA) (closed 30 June 2013)	en.wikipedia.org
Saint Peter's University (NJ)	www.saintpeters.edu
Saint Petersburg College (FL)	www.spcollege.edu
Saint Thomas Aquinas College (NY)	www.stac.edu
Saint Thomas University (FL)	www.stu.edu
Saint Vincent College (PA)	www.stvincent.edu
Saint Vincent de Paul Regional Seminary (FL)	www.svdp.edu
Saint Vincent's College (CT)	www.stvincentscollege.edu
Saint Xavier University (IL)	www.sxu.edu
Salem College (NC)	www.salem.edu
Salem International University (WV)	www.salemu.edu
Salem State University (MA)	www.salemstate.edu
Salisbury University (MD)	www.salisbury.edu
Salish Kootenai College (MT)	www.skc.edu
Salus University (PA)	www.salus.edu
Salve Regina University (RI)	www.salve.edu
Sam Houston State University (TX)	www.shsu.edu
Samford University (AL)	www.samford.edu
Samuel Merritt University (CA)	www.samuelmerritt.edu
San Diego Christian College (CA)	sdcc.edu
San Diego State University (CA)	www.sdsu.edu
San Francisco Art Institute (CA)	www.sfai.edu
San Francisco Conservatory of Music (CA)	www.sfcm.edu
San Francisco State University (CA)	www.sfsu.edu
San Francisco Theological Seminary (CA)	www.sfts.edu
San Joaquin College of Law (CA)	www.sjcl.edu
San José State University (CA)	www.sjsu.edu
San Juan Bautista School of Medicine (PR)	www.sanjuanbautista.edu
Sanford College of Nursing (ND)	bismarck.sanfordhealth.org
Santa Clara University (CA)	www.scu.edu
Santa Fe College (FL)	www.sfcollege.edu
Santa Fe University of Art & Design (NM)	santafeuniversity.edu
Sarah Lawrence College (NY)	www.slc.edu
Savannah College of Art & Design (GA)	www.scad.edu
Savannah State University (GA)	www.savannahstate.edu
Saybrook University (CA)	www.saybrook.edu
School for International Training (VT)	www.sit.edu
School of the Art Institute of Chicago (IL)	www.saic.edu
School of Visual Arts (NY)	www.sva.edu
Schreiner University (TX)	www.schreiner.edu
Scripps Research Institute (CA)	www.scripps.edu
Seattle Pacific University (WA)	www.spu.edu
Seattle University (WA)	www.seattleu.edu
Seminario Evangélico de Puerto Rico (PR)	www.se-pr.edu
Seminary of the Immaculate Conception (NY)	www.icseminary.edu
Seminary of the Southwest (TX)	www.ssw.edu
Seminole State College of Florida (FL)	www.seminolestate.edu
Seton Hall University (NJ)	www.shu.edu
Seton Hill University (PA)	www.setonhill.edu
Shaw University (NC)	www.shawu.edu
Shawnee State University (OH)	www.shawnee.edu
Shenandoah University (VA)	www.su.edu
Shepherd University (WV)	www.shepherd.edu
Sherman College of Chiropractic (SC)	www.sherman.edu
Shimer College (IL)	www.shimer.edu
Shippensburg University of Pennsylvania (PA)	www.ship.edu
Shorter University (GA)	su.shorter.edu
Siena College (NY)	www.siena.edu
Siena Heights University (MI)	www.sienaheights.edu
Sierra Nevada College (NV)	www.sierranevada.edu
Silver Lake College (WI)	www.sl.edu
Simmons College (MA)	www.simmons.edu
Sinte Gleska University (SD)	www.sintegleska.edu
Simpson University (CA)	simpsonu.edu
Simpson College (IA)	simpson.edu
Sioux Falls Seminary (SD)	sfseminary.edu
Sistema Universitario Ana G. Méndez (PR)	www.suagm.edu
Sistema Universitario Ana G. Méndez (PR) Universidad del Este	www.suagm.edu
Sistema Universitario Ana G. Méndez (PR) Universidad Metropolitana	www.suagm.edu
Sistema Universitario Ana G. Méndez (PR) Universidad del Turabo	www.suagm.edu
Sitting Bull College (ND)	www.sittingbull.edu
Skidmore College (NY)	www.skidmore.edu
Slippery Rock University of Pennsylvania (PA)	www.sru.edu
Smith College (MA)	www.smith.edu
Sofia University (CA)	www.sofia.edu
Soka University of America (CA)	www.soka.edu
Sonoma State University (CA)	www.sonoma.edu
Soujourner-Douglass College (MD)	www.sdc.edu
South Carolina State University (SC)	www.scsu.edu
South College (TN)	www.southcollegetn.edu
South Dakota School of Mines & Technology (SD)	www.sdsmt.edu
South Dakota State University (SD)	www.sdstate.edu
South Florida Bible College & Theological Seminary (FL)	www.sfbc.edu
South Florida State College (FL)	www.southflorida.edu
South Georgia State College (GA)	www.sgsc.edu
South Texas College of Law (TX)	www.stcl.edu
South University (GA)	www.southuniversity.edu
Southeast Missouri State University (MO)	www.semo.edu
Southeastern Baptist Theological Seminary (NC)	www.sebts.edu
Southeastern Bible College (AL)	www.sebc.edu
Southeastern University (FL)	www.seu.edu
Southeastern Louisiana University (LA)	www.southeastern.edu
Southeastern Oklahoma State University (OK)	www.se.edu
Southern Adventist University (TN)	www.southern.edu
Southern Arkansas University (AR)	web.saumag.edu
Southern Baptist Theological Seminary (KY)	www.sbts.edu
Southern California College of Optometry (CA)	www.ketchum.edu
Southern California Institute of Architecture (CA)	www.sciarc.edu
Southern California University of Health Sciences (CA)	www.scuhs.edu
Southern College of Optometry (TN)	www.sco.edu
Southern Connecticut State University (CT)	www.southernct.edu
Southern Illinois University–Carbondale (IL)	siu.edu
Southern Illinois University–Edwardsville (IL)	www.siue.edu
Southern Methodist University (TX)	www.smu.edu
Southern Nazarene University (OK)	snu.edu
Southern New Hampshire University (NH)	www.snhu.edu
Southern Oregon University (OR)	www.sou.edu
Southern Polytechnic State University (GA)	www.spsu.edu
Southern University and A&M College at Baton Rouge (LA)	www.subr.edu
Southern University at New Orleans (LA)	suno.edu
Southern University at Shreveport (LA)	www.susla.edu
Southern University System (LA)	www.sus.edu
Southern Utah University (UT)	www.suu.edu
Southern Vermont College (VT)	www.svc.edu
Southern Virginia University (VA)	svu.edu
Southern Wesleyan University (SC)	www.swu.edu
Southwest Baptist University (MO)	www.sbuniv.edu
Southwest College of Naturopathic Medicine & Health Sciences (AZ)	www.scnm.edu
Southwest Minnesota State University (MN)	www.smsu.edu
Southwest University of Visual Arts (AZ)	www.suva.edu
Southwestern Adventist University (TX)	www.swau.edu
Southwestern Assemblies of God University (TX)	www.sagu.edu
Southwestern Baptist Theological Seminary (TX)	www.swbts.edu
Southwestern Christian College (TX)	www.swcc.edu
Southwestern Christian University (OK)	www.swcu.edu
Southwestern College (KS)	www.sckans.edu
Southwestern College (NM)	swc.edu
Southwestern Oklahoma State University (OK)	www.swosu.edu
Southwestern University (TX)	www.southwestern.edu
Spalding University (KY)	spalding.edu
Spelman College (GA)	www.spelman.edu
Spertus Institute of Jewish Studies (IL)	www.spertus.edu
Spring Arbor University (MI)	www.arbor.edu
Spring Hill College (AL)	www.shc.edu
Springfield College (MA)	www.springfieldcollege.edu
Stanford University (CA)	www.stanford.edu
State College of Florida, Manatee-Sarasota (FL)	www.scf.edu
State University of New York System (NY)	www.suny.edu
State University of New York System (NY) Albany	www.albany.edu
State University of New York System (NY) Alfred State University	www.alfredstate.edu
State University of New York System (NY) Binghamton	www.binghamton.edu
State University of New York System (NY) Buffalo	 	www.buffalo.edu
State University of New York System (NY) Buffalo State College	suny.buffalostate.edu
State University of New York System (NY) College at Brockport	www.brockport.edu
State University of New York System (NY) College at Cortland	www.cortland.edu
State University of New York System (NY) College at Fredonia	www.fredonia.edu
State University of New York System (NY) College at Geneseo	www.geneseo.edu
State University of New York System (NY) College at New Paltz	www.newpaltz.edu
State University of New York System (NY) College at Old Westbury	www.oldwestbury.edu
State University of New York System (NY) College at Oneonta	www.oneonta.edu
State University of New York System (NY) College at Oswego	www.oswego.edu
State University of New York System (NY) College at Plattsburgh	www.plattsburgh.edu
State University of New York System (NY) College at Potsdam	www.potsdam.edu
State University of New York System (NY) College at Purchase	www.purchase.edu
State University of New York System (NY) College of Agriculture & Technology at Cobleskill	www.cobleskill.edu
State University of New York System (NY) College of Agriculture & Technology at Morrisville (Morrisville State College)	www.morrisville.edu
State University of New York System (NY) College of Environmental Science & Forestry	www.esf.edu
State University of New York System (NY) College of Optometry	www.sunyopt.edu
State University of New York System (NY) College of Technology at Canton	www.canton.edu
State University of New York System (NY) College of Technology at Delhi	www.delhi.edu
State University of New York System (NY) Downstate Medical Center	www.downstate.edu
State University of New York System (NY) Empire State College	www.esc.edu
State University of New York System (NY) Farmingdale State College	www.farmingdale.edu
State University of New York System (NY) Fashion Institute of Technology	www.fitnyc.edu
State University of New York System (NY) Institute of Technology at Utica/Rome	www.sunyit.edu
State University of New York System (NY) Maritime College at Fort Schuyler	www.sunymaritime.edu
State University of New York System (NY) Stony Brook University	www.stonybrook.edu
State University of New York System (NY) Upstate Medical University	www.upstate.edu
Stephen F. Austin State University (TX)	www.sfasu.edu
Stephens College (MO)	www.stephens.edu
Sterling College (KS)	www.sterling.edu
Sterling College (VT)	www.sterlingcollege.edu
Stetson University (FL)	www.stetson.edu
Stevens Institute of Technology (NJ)	www.stevens.edu
Stevenson University (MD)	www.stevenson.edu
Stillman College (AL)	www.stillman.edu
Stonehill College (MA)	www.stonehill.edu
Strayer University (DC)	www.strayer.edu
Suffolk University (MA)	www.suffolk.edu
Sul Ross State University (TX)	www.sulross.edu
Sullivan University (KY)	www.sullivan.edu
Susquehanna University (PA)	www.susqu.edu
Swarthmore College (PA)	www.swarthmore.edu
Sweet Briar College (VA)	sbc.edu
Syracuse University (NY)	www.syr.edu
University of the Pacific (CA)	www.pacific.edu
University of Pennsylvania (PA)	www.upenn.edu
University of Phoenix (AZ)	www.phoenix.edu
University of Pikeville (KY)	www.upike.edu
University of Pittsburgh (PA)	www.pitt.edu
University of Pittsburgh–Bradford (PA)	www.upb.pitt.edu
University of Pittsburgh–Greensburg (PA)	www.greensburg.pitt.edu
University of Pittsburgh–Johnstown (PA)	www.upj.pitt.edu
University of Portland (OR)	www.up.edu
University of the Potomac (DC)	www.potomac.edu
University of Puerto Rico–Aguadilla (PR)	www.uprag.edu
University of Puerto Rico–Arecibo (PR)	www.upra.edu
University of Puerto Rico–Bayamón (PR)	www.uprb.edu
University of Puerto Rico–Carolina (PR)	www.uprc.edu
University of Puerto Rico–Cayey (PR)	www.cayey.upr.edu
University of Puerto Rico–Ciencias Médicas (PR)	www.rcm.upr.edu
University of Puerto Rico–Humacao (PR)	www.uprh.edu
University of Puerto Rico–Mayagüez (PR)	www.uprm.edu
University of Puerto Rico–Ponce (PR)	www.uprp.edu
University of Puerto Rico–Río Piedras (PR)	www.uprrp.edu
University of Puerto Rico System (PR)	www.upr.edu
University of Puerto Rico–Utuado (PR)	www.uprutuado.edu
University of Puget Sound (WA)	www.pugetsound.edu
University of Redlands (CA)	www.redlands.edu
University of Rhode Island (RI)	www.uri.edu
University of Richmond (VA)	www.richmond.edu
University of Rio Grande (OH)	www.rio.edu
University of Rochester (NY)	www.rochester.edu
University of the Rockies (CO)	www.rockies.edu
University of Saint Francis (IL)	www.stfrancis.edu
University of Saint Francis (IN)	www.sf.edu
University of Saint Joseph (CT)	www.usj.edu
University of Saint Mary (KS)	www.stmary.edu
University of San Diego (CA)	www.sandiego.edu
University of San Francisco (CA)	www.usfca.edu
University of Science & Arts of Oklahoma (OK)	65.64.85.221
University of the Sciences in Philadelphia (PA)	www.usciences.edu
University of Scranton (PA)	www.scranton.edu
University of Sioux Falls (SD)	www.usiouxfalls.edu
University of Southern California (CA)	www.usc.edu
University of Southern Maine (ME)	usm.maine.edu
University of South Carolina (SC)	www.sc.edu
University of South Carolina–Aiken (SC)	www.usca.edu
University of South Carolina–Beaufort (SC)	www.uscb.edu
University of South Carolina System (SC)	www.sc.edu
University of South Carolina–Upstate (SC)	www.uscupstate.edu
University of South Dakota (SD)	www.usd.edu
University of South Florida (FL)	www.usf.edu
University of South Florida Saint Petersburg (FL)	www.usfsp.edu
University of South Florida Sarasota–Manatee (FL)	usfsm.edu
University of Southern Mississippi (MS)	www.usm.edu
University of Saint Thomas (TX)	www.stthom.edu
University of Saint Thomas (MN)	www.stthomas.edu
University of South Alabama (AL)	www.southalabama.edu
University of Southern Indiana (IN)	www.usi.edu
University of Tampa (FL)	www.ut.edu
University of Tennessee (TN)	www.utk.edu
University of Tennessee–Chattanooga (TN)	www.utc.edu
University of Tennessee Health Science Center (TN)	www.uthsc.edu
University of Tennessee–Martin (TN)	www.utm.edu
University of Tennessee System (TN)	www.tennessee.edu
University of Texas–Arlington (TX)	www.uta.edu
University of Texas–Austin (TX)	www.utexas.edu
University of Texas–Brownsville (TX)	www.utb.edu
University of Texas–Dallas (TX)	www.utdallas.edu
University of Texas–El Paso (TX)	www.utep.edu
University of Texas Health Science Center at Houston (TX)	www.uth.edu
University of Texas Health Science Center at San Antonio (TX)	www.uthscsa.edu
University of Texas Health Science Center at Tyler (TX)	www.uthealth.org
University of Texas M.D. Anderson Cancer Center (TX)	www.mdanderson.org
University of Texas Medical Branch at Galveston (TX)	www.utmb.edu
University of Texas–Pan American (TX)	www.utpa.edu
University of Texas of the Permian Basin (TX)	www.utpb.edu
University of Texas–San Antonio (TX)	utsa.edu
University of Texas Southwestern Medical Center at Dallas (TX)	www.utsouthwestern.edu
University of Texas System (TX)	www.utsystem.edu
University of Texas–Tyler (TX)	www.uttyler.edu
University of the Arts (PA)	www.uarts.edu
University of the Cumberlands (KY)	www.ucumberlands.edu
University of the Incarnate Word (TX)	www.uiw.edu
University of the South (TN)	www.sewanee.edu
University of the Southwest (NM)	www.usw.edu
University of Toledo (OH)	www.utoledo.edu
University of Tulsa (OK)	www.utulsa.edu
University of Utah (UT)	www.utah.edu
University of Vermont (VT)	www.uvm.edu
University of the Virgin Islands (VI)	www.uvi.edu
University of Virginia (VA)	www.virginia.edu
University of Virginia's College at Wise (VA)	www.wise.virginia.edu
University of Washington (WA)	www.washington.edu
University of Washington–Bothell (WA)	www.bothell.washington.edu
University of Washington–Tacoma (WA)	www.tacoma.uw.edu
University of West Alabama (AL)	www.uwa.edu
University of West Florida (FL)	uwf.edu
University of West Georgia (GA)	www.westga.edu
University of Western States (OR)	www.uws.edu
University of the West (CA)	www.uwest.edu
University of Wisconsin–Eau Claire (WI)	www.uwec.edu
University of Wisconsin–Green Bay (WI)	www.uwgb.edu
University of Wisconsin–La Crosse (WI)	www.uwlax.edu
University of Wisconsin–Madison (WI)	www.wisc.edu
University of Wisconsin–Milwaukee (WI)	www4.uwm.edu
University of Wisconsin–Oshkosh (WI)	www.uwosh.edu
University of Wisconsin–Parkside (WI)	www.uwp.edu
University of Wisconsin–Platteville (WI)	www.uwplatt.edu
University of Wisconsin–River Falls (WI)	www.uwrf.edu
University of Wisconsin–Stevens Point (WI)	www.uwsp.edu
University of Wisconsin–Stout (WI)	www.uwstout.edu
University of Wisconsin–Superior (WI)	www.uwsuper.edu
University of Wisconsin System (WI)	www.wisconsin.edu
University of Wisconsin–Whitewater (WI)	www.uww.edu
University of Wyoming (WY)	www.uwyo.edu
Xavier University (OH)	www.xavier.edu
Xavier University of Louisiana (LA)	www.xula.edu
Yale University (CT)	www.yale.edu
Yeshiva University (NY)	www.yu.edu
York College (NE)	www.ycpanthers.com
York College of Pennsylvania (PA)	www.ycp.edu
Young Harris College (GA)	www.yhc.edu
Youngstown State University (OH)	www.ysu.edu